dateTime	currentBalanceReportId	currentBalance	amount	lineItem	detail	transactionType	recordCount	recordsPerPage	pageNumber	pageCount	startId	endId
1421360328247	1	1000.0	-1000.0	Expired Earnings		Expired Earnings	850	850	1	1	1	850
1421954314354	2	3000.0	2000.0	Lease CCR	VID:1113240034315	Voucher - Void	850	850	1	1	1	850
1421954349081	3	2500.0	-500.0	Lease CCR	VID:1113240036915	Voucher	850	850	1	1	1	850
1421955071341	4	3000.0	500.0	Lease CCR	VID:1113240036915	Voucher - Void	850	850	1	1	1	850
1421955098918	5	2500.0	-500.0	Lease CCR	VID:1113240037015	Voucher	850	850	1	1	1	850
1421955240891	6	3000.0	500.0	Lease CCR	VID:1113240037015	Voucher - Void	850	850	1	1	1	850
1421955301572	7	2500.0	-500.0	Lease CCR	VID:1113240037115	Voucher	850	850	1	1	1	850
1421955400650	8	3000.0	500.0	Lease CCR	VID:1113240037115	Voucher - Void	850	850	1	1	1	850
1421955433017	9	2500.0	-500.0	Lease CCR	VID:1113240037315	Voucher	850	850	1	1	1	850
1421955818970	10	3000.0	500.0	Lease CCR	VID:1113240037315	Voucher - Void	850	850	1	1	1	850
1421955852885	11	2500.0	-500.0	Lease CCR	VID:1113240037415	Voucher	850	850	1	1	1	850
1421956111649	12	2869.0	369.0	CPO Certification Fee Reimbursement	VID:1113240034615	Voucher - Void	850	850	1	1	1	850
1421956136240	13	2369.0	-500.0	GMF Dealer Source Vehicle Purchase Rebate	VID:1113240037615	Voucher	850	850	1	1	1	850
1421956758390	14	2869.0	500.0	Retail Down Payment Assistance	VID:1113240035815	Voucher - Void	850	850	1	1	1	850
1421956790949	15	2369.0	-500.0	Lease CCR	VID:1113240037715	Voucher	850	850	1	1	1	850
1421958290387	16	2869.0	500.0	GM Accessories Reimbursement	VID:1113240035115	Voucher - Void	850	850	1	1	1	850
1421958699158	17	3369.0	500.0	Lease CCR	VID:1113240037715	Voucher - Void	850	850	1	1	1	850
1421958798910	18	3368.0	-1.0	CBCGP - Maintenance Premium Reimbursement	VID:1113240038615	Voucher	850	850	1	1	1	850
1421970420402	19	2368.0	-1000.0	GMF Dealership Training Discount	VID:1113240038715	Voucher	850	850	1	1	1	850
1422040412137	20	52491.0	50123.0	Expired Earnings		Expired Earnings	850	850	1	1	1	850
1422041958260	21	102614.0	50123.0	Expired Earnings		Expired Earnings	850	850	1	1	1	850
1422043129269	22	103033.0	419.0	CPO Certification Fee Reimbursement	VID:1113240035215	Voucher - Void	850	850	1	1	1	850
1422043232991	23	103533.0	500.0	Lease CCR	VID:1113240037415	Voucher - Void	850	850	1	1	1	850
1422293908587	24	103033.0	-500.0	GM Accessories Reimbursement	VID:1113240041115	Voucher	850	850	1	1	1	850
1422294615911	25	103032.0	-1.0	EOT Excess Mileage Fee Waiver	VID:1113240041715	Voucher	850	850	1	1	1	850
1422294699404	26	103031.0	-1.0	EOT Excess Wear Fee Waiver	VID:1113240041815	Voucher	850	850	1	1	1	850
1422296107415	27	103031.0	0.0	Dealer Dividend Cash	VID:1113240042215	Voucher	850	850	1	1	1	850
1422296137032	28	103031.0	0.0	Dealer Dividend Cash	VID:1113240042415	Voucher	850	850	1	1	1	850
1422296326737	29	103031.0	0.0	Dealer Dividend Cash	VID:1113240042615	Voucher	850	850	1	1	1	850
1422296457951	30	102531.0	-500.0	GM Accessories Reimbursement	VID:1113240042815	Voucher	850	850	1	1	1	850
1422296591863	31	101531.0	-1000.0	GMF Dealership Training Discount	VID:1113240043015	Voucher	850	850	1	1	1	850
1422296786481	32	100531.0	-1000.0	GMF Dealership Training Discount	VID:1113240043115	Voucher	850	850	1	1	1	850
1422296854238	33	100031.0	-500.0	GMF Dealer Source Vehicle Purchase Rebate	VID:1113240043315	Voucher	850	850	1	1	1	850
1422296919137	34	100030.0	-1.0	CBCGP - Maintenance Premium Reimbursement	VID:1113240043615	Voucher	850	850	1	1	1	850
1422297001665	35	100029.0	-1.0	CBCGP  - Tire & Wheel Premium Reimbursement	VID:1113240043815	Voucher	850	850	1	1	1	850
1422297061541	36	100028.0	-1.0	CBCGP - VSC Premium Reimbursement	VID:1113240044115	Voucher	850	850	1	1	1	850
1422297245346	37	100027.0	-1.0	CBCGP - GAP Premium Reimbursement	VID:1113240044215	Voucher	850	850	1	1	1	850
1422297702654	38	100026.0	-1.0	EOT Excess Wear Fee Waiver	VID:1113240044315	Voucher	850	850	1	1	1	850
1422297763181	39	100025.0	-1.0	EOT Excess Mileage Fee Waiver	VID:1113240044415	Voucher	850	850	1	1	1	850
1422297794318	40	99690.0	-335.0	XS Wear Premium Reimbursement	VID:1113240044515	Voucher	850	850	1	1	1	850
1422298001757	41	99690.0	0.0	Dealer Dividend Cash	VID:1113240044615	Voucher	850	850	1	1	1	850
1422355385131	42	99690.0	0.0	Dealer Dividend Cash	VID:1113240047215	Voucher	850	850	1	1	1	850
1422356996780	43	99190.0	-500.0	Retail Down Payment Assistance	VID:1113240047315	Voucher	850	850	1	1	1	850
1422357613689	44	98190.0	-1000.0	GMF Dealership Training Discount	VID:1113240047615	Voucher	850	850	1	1	1	850
1422385899709	45	97690.0	-500.0	Retail Down Payment Assistance	VID:1113240049015	Voucher	850	850	1	1	1	850
1422387871350	46	97691.0	1.0	CBCGP - GAP Premium Reimbursement	VID:1113240044215	Voucher - Void	850	850	1	1	1	850
1422388533671	47	97690.0	-1.0	EOT Excess Wear Fee Waiver	VID:1113240049315	Voucher	850	850	1	1	1	850
1422394630493	48	98690.0	1000.0		Initial Deposit	Enrollment Deposit	850	850	1	1	1	850
1422398258824	49	99190.0	500.0	GM Accessories Reimbursement	VID:1113240042815	Voucher - Void	850	850	1	1	1	850
1422446240567	50	98190.0	-1000.0	Retail Down Payment Assistance	VID:1113240049715	Voucher	850	850	1	1	1	850
1422449886486	51	97855.0	-335.0	XS Wear Premium Reimbursement	VID:1113240050015	Voucher	850	850	1	1	1	850
1422476039327	52	97854.0	-1.0	EOT Excess Mileage Fee Waiver	VID:1113240052015	Voucher	850	850	1	1	1	850
1422476688081	53	97853.0	-1.0	CBCGP - Maintenance Premium Reimbursement	VID:1113240052415	Voucher	850	850	1	1	1	850
1422478143478	54	96853.0	-1000.0	GMF Dealership Training Discount	VID:1113240052615	Voucher	850	850	1	1	1	850
1422478191518	55	96853.0	0.0	Dealer Dividend Cash	VID:1113240052815	Voucher	850	850	1	1	1	850
1422485647141	56	97188.0	335.0	XS Wear Premium Reimbursement	VID:1113240050015	Voucher - Void	850	850	1	1	1	850
1422485812126	57	98188.0	1000.0	Retail Down Payment Assistance	VID:1113240049715	Voucher - Void	850	850	1	1	1	850
1422485905620	58	98188.0	0.0	Dealer Dividend Cash	VID:1113240053315	Voucher	850	850	1	1	1	850
1422486165367	59	98189.0	1.0	EOT Excess Wear Fee Waiver	VID:1113240049315	Voucher - Void	850	850	1	1	1	850
1422486214663	60	98189.0	0.0	Dealer Dividend Cash	VID:1113240053415	Voucher	850	850	1	1	1	850
1422486256662	61	98189.0	0.0	Dealer Dividend Cash	VID:1113240053515	Voucher	850	850	1	1	1	850
1422486274329	62	97189.0	-1000.0	GMF Dealership Training Discount	VID:1113240053715	Voucher	850	850	1	1	1	850
1422556013482	63	97189.0	0.0	Dealer Dividend Cash	VID:1113240056215	Voucher	850	850	1	1	1	850
1422556030800	64	97189.0	0.0	Dealer Dividend Cash	VID:1113240056315	Voucher	850	850	1	1	1	850
1422556173973	65	97189.0	0.0	Dealer Dividend Cash	VID:1113240056415	Voucher	850	850	1	1	1	850
1422632672706	66	97189.0	0.0	Dealer Dividend Cash	VID:1113240057015	Voucher	850	850	1	1	1	850
1422632701370	67	97189.0	0.0	Dealer Dividend Cash	VID:1113240057115	Voucher	850	850	1	1	1	850
1422635014302	68	97189.0	0.0	Dealer Dividend Cash	VID:1113240057515	Voucher	850	850	1	1	1	850
1422636785201	69	96189.0	-1000.0	GMF Dealership Training Discount	VID:1113240058615	Voucher	850	850	1	1	1	850
1422636955778	70	96188.0	-1.0	CBCGP  - Tire & Wheel Premium Reimbursement	VID:1113240058715	Voucher	850	850	1	1	1	850
1422638661045	71	96188.0	0.0	Dealer Dividend Cash	VID:1113240059315	Voucher	850	850	1	1	1	850
1422645104284	72	96188.0	0.0	Dealer Dividend Cash	VID:1113240060015	Voucher	850	850	1	1	1	850
1422653379327	73	95188.0	-1000.0	GMF Dealership Training Discount	VID:1113240060515	Voucher	850	850	1	1	1	850
1422659379000	74	94188.0	-1000.0	GMF Dealership Training Discount	VID:1113240060915	Voucher	850	850	1	1	1	850
1422890060608	75	93188.0	-1000.0	GMF Dealership Training Discount	VID:1113240061015	Voucher	850	850	1	1	1	850
1422893144026	76	92188.0	-1000.0	GMF Dealership Training Discount	VID:1113240061115	Voucher	850	850	1	1	1	850
1422903208667	77	91188.0	-1000.0	GMF Dealership Training Discount	VID:1113240062015	Voucher	850	850	1	1	1	850
1422903298129	78	92188.0	1000.0	GMF Dealership Training Discount	VID:1113240061015	Voucher - Void	850	850	1	1	1	850
1422903303078	79	93188.0	1000.0	GMF Dealership Training Discount	VID:1113240061115	Voucher - Void	850	850	1	1	1	850
1422903308905	80	94188.0	1000.0	GMF Dealership Training Discount	VID:1113240062015	Voucher - Void	850	850	1	1	1	850
1422905024315	81	93188.0	-1000.0	GMF Dealership Training Discount	VID:1113240062415	Voucher	850	850	1	1	1	850
1422905642610	82	94188.0	1000.0	GMF Dealership Training Discount	VID:1113240062415	Voucher - Void	850	850	1	1	1	850
1422905658428	83	93188.0	-1000.0	GMF Dealership Training Discount	VID:1113240062815	Voucher	850	850	1	1	1	850
1422912560573	84	93188.0	0.0	Dealer Dividend Cash	VID:1113240063415	Voucher	850	850	1	1	1	850
1422912649376	85	93188.0	0.0	Dealer Dividend Cash	VID:1113240063415	Voucher - Void	850	850	1	1	1	850
1422912666690	86	93188.0	0.0	Dealer Dividend Cash	VID:1113240063515	Voucher	850	850	1	1	1	850
1422912810527	87	93188.0	0.0	Dealer Dividend Cash	VID:1113240063615	Voucher	850	850	1	1	1	850
1422913067733	88	93188.0	0.0	Dealer Dividend Cash	VID:1113240063915	Voucher	850	850	1	1	1	850
1422913088812	89	93188.0	0.0	Dealer Dividend Cash	VID:1113240064015	Voucher	850	850	1	1	1	850
1422914079772	90	92688.0	-500.0	Retail Down Payment Assistance	VID:1113240064315	Voucher	850	850	1	1	1	850
1422914312218	91	93188.0	500.0	Retail Down Payment Assistance	VID:1113240064315	Voucher - Void	850	850	1	1	1	850
1422914468090	92	92688.0	-500.0	Lease CCR	VID:1113240064515	Voucher	850	850	1	1	1	850
1422914611452	93	93188.0	500.0	Lease CCR	VID:1113240064515	Voucher - Void	850	850	1	1	1	850
1422914891032	94	92819.0	-369.0	CPO Certification Fee Reimbursement	VID:1113240064815	Voucher	850	850	1	1	1	850
1422997181170	95	92818.0	-1.0	EOT Excess Mileage Fee Waiver	VID:1113240065515	Voucher	850	850	1	1	1	850
1423003613972	96	92817.0	-1.0	CBCGP - Maintenance Premium Reimbursement	VID:1113240066715	Voucher	850	850	1	1	1	850
1423057717525	97	93186.0	369.0	CPO Certification Fee Reimbursement	VID:1113240064815	Voucher - Void	850	850	1	1	1	850
1423057946939	98	92686.0	-500.0	Retail Down Payment Assistance	VID:1113240067215	Voucher	850	850	1	1	1	850
1423058231394	99	93186.0	500.0	Retail Down Payment Assistance	VID:1113240067215	Voucher - Void	850	850	1	1	1	850
1423067011902	100	94185.0	999.0	GMF Dealership Training Discount	VID:1113240047615	Voucher - Void	850	850	1	1	1	850
1423067011902	101	94532.0	-347.0	Expired Earnings	Jan 2014	Expired Earnings	850	850	1	1	1	850
1423073114440	102	93532.0	-1000.0	GMF Dealership Training Discount	VID:1113240067415	Voucher	850	850	1	1	1	850
1423073183982	103	93532.0	0.0	EOT Excess Mileage Fee Waiver	VID:1113240065515	Voucher - Void	850	850	1	1	1	850
1423073188761	104	93532.0	0.0	CBCGP - Maintenance Premium Reimbursement	VID:1113240066715	Voucher - Void	850	850	1	1	1	850
1423073193960	105	94532.0	1000.0	GMF Dealership Training Discount	VID:1113240067415	Voucher - Void	850	850	1	1	1	850
1423076637778	106	94532.0	0.0	Dealer Dividend Cash	VID:1113240067615	Voucher	850	850	1	1	1	850
1423076809698	107	94532.0	0.0	Dealer Dividend Cash	VID:1113240067615	Voucher - Void	850	850	1	1	1	850
1423079602255	108	94531.0	-1.0	Dealer Dividend Cash	VID:1113240067715	Voucher	850	850	1	1	1	850
1423079689587	109	94532.0	1.0	Dealer Dividend Cash	VID:1113240067715	Voucher - Void	850	850	1	1	1	850
1423079709345	110	94531.0	-1.0	Dealer Dividend Cash	VID:1113240067815	Voucher	850	850	1	1	1	850
1423080110620	111	94530.0	-1.0	Dealer Dividend Cash	VID:1113240067915	Voucher	850	850	1	1	1	850
1423080230164	112	93864.0	-666.0	Dealer Dividend Cash	VID:1113240068115	Voucher	850	850	1	1	1	850
1423080273191	113	93865.0	1.0	Dealer Dividend Cash	VID:1113240067815	Voucher - Void	850	850	1	1	1	850
1423080306943	114	93866.0	1.0	Dealer Dividend Cash	VID:1113240067915	Voucher - Void	850	850	1	1	1	850
1423080355600	115	94532.0	666.0	Dealer Dividend Cash	VID:1113240068115	Voucher - Void	850	850	1	1	1	850
1423080474280	116	94032.0	-500.0	GMF Dealer Source Vehicle Purchase Rebate	VID:1113240068215	Voucher	850	850	1	1	1	850
1423080642441	117	94532.0	500.0	GMF Dealer Source Vehicle Purchase Rebate	VID:1113240068215	Voucher - Void	850	850	1	1	1	850
1423080655887	118	94399.0	-133.0	Dealer Dividend Cash	VID:1113240068315	Voucher	850	850	1	1	1	850
1423083279152	119	94398.0	-1.0	Dealer Dividend Cash	VID:1113240068515	Voucher	850	850	1	1	1	850
1423085493136	120	93898.0	-500.0	GMF Dealer Source Vehicle Purchase Rebate	VID:1113240068615	Voucher	850	850	1	1	1	850
1423113236599	121	93888.0	-10.0	CBCGP - Maintenance Premium Reimbursement	VID:1113240069015	Voucher	850	850	1	1	1	850
1423113340549	122	93898.0	10.0	CBCGP - Maintenance Premium Reimbursement	VID:1113240069015	Voucher - Void	850	850	1	1	1	850
1423114559669	123	92898.0	-1000.0	GMF Dealership Training Discount	VID:1113240069315	Voucher	850	850	1	1	1	850
1423114582312	124	91898.0	-1000.0	GMF Dealership Training Discount	VID:1113240069215	Voucher	850	850	1	1	1	850
1423122503604	125	91398.0	-500.0	GM Accessories Reimbursement	VID:1113240069615	Voucher	850	850	1	1	1	850
1423125581610	126	91898.0	500.0	GM Accessories Reimbursement	VID:1113240069615	Voucher - Void	850	850	1	1	1	850
1423127295890	127	90498.0	-1400.0	EOT Excess Mileage Fee Waiver	VID:1113240069715	Voucher	850	850	1	1	1	850
1423128057667	128	89832.0	-666.0	Dealer Dividend Cash	VID:1113240069815	Voucher	850	850	1	1	1	850
1423128370708	129	90498.0	666.0	Dealer Dividend Cash	VID:1113240069815	Voucher - Void	850	850	1	1	1	850
1423176652060	130	90497.0	-1.0	Dealer Dividend Cash	VID:1113240070015	Voucher	850	850	1	1	1	850
1423176682073	131	90498.0	1.0	Dealer Dividend Cash	VID:1113240070015	Voucher - Void	850	850	1	1	1	850
1423249933150	132	10667.0	-79831.0	Dealer Dividend Cash	VID:1113240071615	Voucher	850	850	1	1	1	850
1423250951719	133	90498.0	79831.0	Dealer Dividend Cash	VID:1113240071615	Voucher - Void	850	850	1	1	1	850
1423482998623	134	90498.0	0.0	CBCGP - Maintenance Premium Reimbursement	VID:1113240052415	Voucher - Void	850	850	1	1	1	850
1423483042786	135	90043.0	-455.0	CBCGP  - Tire & Wheel Premium Reimbursement	VID:1113240072315	Voucher	850	850	1	1	1	850
1423529385391	136	90042.0	-1.0	Dealer Dividend Cash	VID:1113240072415	Voucher	850	850	1	1	1	850
1423564312480	137	89776.0	-266.0	Dealer Dividend Cash	VID:1113240072515	Voucher	850	850	1	1	1	850
1423603578243	138	89776.0	0.0	CBCGP  - Tire & Wheel Premium Reimbursement	VID:1113240058715	Voucher - Void	850	850	1	1	1	850
1423603652097	139	89276.0	-500.0	Retail Down Payment Assistance	VID:1113240074115	Voucher	850	850	1	1	1	850
1423603735604	140	89263.0	-13.0	Dealer Dividend Cash	VID:1113240074315	Voucher	850	850	1	1	1	850
1423604749850	141	88263.0	-1000.0	GMF Dealership Training Discount	VID:1113240074415	Voucher	850	850	1	1	1	850
1423605592703	142	88763.0	500.0	Retail Down Payment Assistance	VID:1113240074115	Voucher - Void	850	850	1	1	1	850
1423613880937	143	88263.0	-500.0	Lease CCR	VID:1113240074715	Voucher	850	850	1	1	1	850
1423655781235	144	88718.0	455.0	CBCGP  - Tire & Wheel Premium Reimbursement	VID:1113240072315	Voucher - Void	850	850	1	1	1	850
1423655837477	145	87523.0	-1195.0	CPO Certification Fee Reimbursement	VID:1113240075315	Voucher	850	850	1	1	1	850
1423676056442	146	87522.0	-1.0	Dealer Dividend Cash	VID:1113240075515	Voucher	850	850	1	1	1	850
1423676204694	147	87523.0	1.0	Dealer Dividend Cash	VID:1113240075515	Voucher - Void	850	850	1	1	1	850
1423684209666	148	87023.0	-500.0	Retail Down Payment Assistance	VID:1113240075815	Voucher	850	850	1	1	1	850
1423684224994	149	87021.0	-2.0	Dealer Dividend Cash	VID:1113240075915	Voucher	850	850	1	1	1	850
1423684290599	150	87019.0	-2.0	Dealer Dividend Cash	VID:1113240076115	Voucher	850	850	1	1	1	850
1423684370373	151	87017.0	-2.0	Dealer Dividend Cash	VID:1113240076315	Voucher	850	850	1	1	1	850
1423687550959	152	87015.0	-2.0	Dealer Dividend Cash	VID:1113240076515	Voucher	850	850	1	1	1	850
1423690855874	153	86515.0	-500.0	Retail Down Payment Assistance	VID:1113240076915	Voucher	850	850	1	1	1	850
1423695807567	154	87015.0	500.0	Retail Down Payment Assistance	VID:1113240076915	Voucher - Void	850	850	1	1	1	850
1423696126743	155	86015.0	-1000.0	Retail Down Payment Assistance	VID:1113240077615	Voucher	850	850	1	1	1	850
1423696485368	156	87015.0	1000.0	Retail Down Payment Assistance	VID:1113240077615	Voucher - Void	850	850	1	1	1	850
1423697983817	157	87014.0	-1.0	CBCGP - VSC Premium Reimbursement	VID:1113240078015	Voucher	850	850	1	1	1	850
1423739124590	158	87015.0	1.0	CBCGP - VSC Premium Reimbursement	VID:1113240078015	Voucher - Void	850	850	1	1	1	850
1423743212747	159	86515.0	-500.0	GM Accessories Reimbursement	VID:1113240078215	Voucher	850	850	1	1	1	850
1423744550792	160	87015.0	500.0	GM Accessories Reimbursement	VID:1113240078215	Voucher - Void	850	850	1	1	1	850
1423765818846	161	87013.0	-2.0	Dealer Dividend Cash	VID:1113240078815	Voucher	850	850	1	1	1	850
1423774283490	162	87011.0	-2.0	CBCGP - Maintenance Premium Reimbursement	VID:1113240079315	Voucher	850	850	1	1	1	850
1423774520387	163	87013.0	2.0	CBCGP - Maintenance Premium Reimbursement	VID:1113240079315	Voucher - Void	850	850	1	1	1	850
1423779007879	164	87011.0	-2.0	Dealer Dividend Cash	VID:1113240079615	Voucher	850	850	1	1	1	850
1423779306480	165	87511.0	500.0	GMF Dealer Source Vehicle Purchase Rebate	VID:1113240068615	Voucher - Void	850	850	1	1	1	850
1423779306480	166	88011.0	-500.0	Expired Earnings	Feb 2014	Expired Earnings	850	850	1	1	1	850
1423779544872	167	87511.0	-500.0	GMF Dealer Source Vehicle Purchase Rebate	VID:1113240080415	Voucher	850	850	1	1	1	850
1423779763043	168	87011.0	-500.0	GMF Dealer Source Vehicle Purchase Rebate	VID:1113240080515	Voucher	850	850	1	1	1	850
1423779811492	169	87511.0	500.0	GMF Dealer Source Vehicle Purchase Rebate	VID:1113240080515	Voucher - Void	850	850	1	1	1	850
1423779821760	170	88011.0	500.0	GMF Dealer Source Vehicle Purchase Rebate	VID:1113240080415	Voucher - Void	850	850	1	1	1	850
1423780204093	171	87011.0	-1000.0	GMF Dealership Training Discount	VID:1113240080615	Voucher	850	850	1	1	1	850
1423780471653	172	86011.0	-1000.0	GMF Dealership Training Discount	VID:1113240080715	Voucher	850	850	1	1	1	850
1423780573912	173	87011.0	1000.0	GMF Dealership Training Discount	VID:1113240080615	Voucher - Void	850	850	1	1	1	850
1423780658168	174	88011.0	1000.0	GMF Dealership Training Discount	VID:1113240080715	Voucher - Void	850	850	1	1	1	850
1423781667457	175	87511.0	-500.0	GM Accessories Reimbursement	VID:1113240080915	Voucher	850	850	1	1	1	850
1423782345433	176	87511.0	0.0	Dealer Dividend Cash	VID:1113240063515	Voucher - Void	850	850	1	1	1	850
1423782359598	177	87511.0	0.0	Dealer Dividend Cash	VID:1113240064015	Voucher - Void	850	850	1	1	1	850
1423782449203	178	88011.0	500.0	GM Accessories Reimbursement	VID:1113240080915	Voucher - Void	850	850	1	1	1	850
1423783390348	179	88009.0	-2.0	Dealer Dividend Cash	VID:1113240081015	Voucher	850	850	1	1	1	850
1423783513269	180	88011.0	2.0	Dealer Dividend Cash	VID:1113240081015	Voucher - Void	850	850	1	1	1	850
1423783538436	181	88009.0	-2.0	Dealer Dividend Cash	VID:1113240081415	Voucher	850	850	1	1	1	850
1423783746101	182	88008.0	-1.0	EOT Excess Mileage Fee Waiver	VID:1113240081815	Voucher	850	850	1	1	1	850
1423820029674	183	87948.0	-60.0	Dealer Dividend Cash	VID:1113240083515	Voucher	850	850	1	1	1	850
1423826613935	184	87913.0	-35.0	Dealer Dividend Cash	VID:1113240083815	Voucher	850	850	1	1	1	850
1423826794764	185	87779.0	-134.0	Dealer Dividend Cash	VID:1113240083915	Voucher	850	850	1	1	1	850
1423828635202	186	87913.0	134.0	Dealer Dividend Cash	VID:1113240083915	Voucher - Void	850	850	1	1	1	850
1423838797111	187	87413.0	-500.0	GM Accessories Reimbursement	VID:1113240084115	Voucher	850	850	1	1	1	850
1423838856026	188	85413.0	-2000.0	Lease CCR	VID:1113240084315	Voucher	850	850	1	1	1	850
1423838989018	189	84413.0	-1000.0	GMF Dealership Training Discount	VID:1113240084415	Voucher	850	850	1	1	1	850
1423839061653	190	84411.0	-2.0	Dealer Dividend Cash	VID:1113240084515	Voucher	850	850	1	1	1	850
1423839134087	191	83911.0	-500.0	GM Accessories Reimbursement	VID:1113240084715	Voucher	850	850	1	1	1	850
1423839176808	192	83411.0	-500.0	Lease CCR	VID:1113240084815	Voucher	850	850	1	1	1	850
1423839216993	193	82911.0	-500.0	Retail Down Payment Assistance	VID:1113240084915	Voucher	850	850	1	1	1	850
1423842194732	194	82909.0	-2.0	Dealer Dividend Cash	VID:1113240085115	Voucher	850	850	1	1	1	850
1423854731435	195	81909.0	-1000.0	GMF Dealership Training Discount	VID:1113240092015	Voucher	850	850	1	1	1	850
1423854897396	196	80909.0	-1000.0	GMF Dealership Training Discount	VID:1113240092215	Voucher	850	850	1	1	1	850
1423855998333	197	79909.0	-1000.0	GMF Dealership Training Discount	VID:1113240093515	Voucher	850	850	1	1	1	850
1423856459180	198	80409.0	500.0	Lease CCR	VID:1113240074715	Voucher - Void	850	850	1	1	1	850
1423856459180	199	80909.0	-500.0	Expired Earnings	Apr 2014	Expired Earnings	850	850	1	1	1	850
1423856489728	200	80409.0	-500.0	GM Accessories Reimbursement	VID:1113240094515	Voucher	850	850	1	1	1	850
1423858066022	201	80074.0	-335.0	XS Wear Premium Reimbursement	VID:1113240094815	Voucher	850	850	1	1	1	850
1423858102907	202	78074.0	-2000.0	Retail Down Payment Assistance	VID:1113240094915	Voucher	850	850	1	1	1	850
1423858365122	203	78072.0	-2.0	Dealer Dividend Cash	VID:1113240095015	Voucher	850	850	1	1	1	850
1423859547268	204	78062.0	-10.0	EOT Excess Mileage Fee Waiver	VID:1113240095115	Voucher	850	850	1	1	1	850
1423862154231	205	79062.0	1000.0	GMF Dealership Training Discount	VID:1113240062815	Voucher - Void	850	850	1	1	1	850
1423862154231	206	80062.0	-1000.0	Expired Earnings	Mar 2014	Expired Earnings	850	850	1	1	1	850
1423862162738	207	80062.0	0.0	Dealer Dividend Cash	VID:1113240063615	Voucher - Void	850	850	1	1	1	850
1423862169352	208	80062.0	0.0	Dealer Dividend Cash	VID:1113240063915	Voucher - Void	850	850	1	1	1	850
1423862456561	209	81062.0	1000.0	GMF Dealership Training Discount	VID:1113240084415	Voucher - Void	850	850	1	1	1	850
1423867796916	210	80062.0	-1000.0	GMF Dealership Training Discount	VID:1113240095315	Voucher	850	850	1	1	1	850
1423868099362	211	81062.0	1000.0	GMF Dealership Training Discount	VID:1113240095315	Voucher - Void	850	850	1	1	1	850
1424067149019	212	79062.0	-2000.0	Retail Down Payment Assistance	VID:1113240095615	Voucher	850	850	1	1	1	850
1424068209079	213	81062.0	2000.0	Retail Down Payment Assistance	VID:1113240095615	Voucher - Void	850	850	1	1	1	850
1424079450516	214	79062.0	-2000.0	Lease CCR	VID:1113240095815	Voucher	850	850	1	1	1	850
1424079917037	215	81062.0	2000.0	Lease CCR	VID:1113240095815	Voucher - Void	850	850	1	1	1	850
1424087196702	216	80062.0	-1000.0	GMF Dealer Source Vehicle Purchase Rebate	VID:1113240096115	Voucher	850	850	1	1	1	850
1424087275543	217	81062.0	1000.0	GMF Dealer Source Vehicle Purchase Rebate	VID:1113240096115	Voucher - Void	850	850	1	1	1	850
1424103705228	218	81060.0	-2.0	Dealer Dividend Cash	VID:1113240096215	Voucher	850	850	1	1	1	850
1424103749968	219	81058.0	-2.0	Dealer Dividend Cash	VID:1113240096415	Voucher	850	850	1	1	1	850
1424103835412	220	81056.0	-2.0	Dealer Dividend Cash	VID:1113240096615	Voucher	850	850	1	1	1	850
1424103873314	221	80056.0	-1000.0	GMF Dealership Training Discount	VID:1113240096715	Voucher	850	850	1	1	1	850
1424104079846	222	80057.0	1.0	EOT Excess Mileage Fee Waiver	VID:1113240081815	Voucher - Void	850	850	1	1	1	850
1424104085198	223	82057.0	2000.0	Lease CCR	VID:1113240084315	Voucher - Void	850	850	1	1	1	850
1424104090321	224	82557.0	500.0	GM Accessories Reimbursement	VID:1113240084715	Voucher - Void	850	850	1	1	1	850
1424104114223	225	82556.0	-1.0	EOT Excess Mileage Fee Waiver	VID:1113240097015	Voucher	850	850	1	1	1	850
1424104157133	226	81556.0	-1000.0	GMF Dealership Training Discount	VID:1113240097215	Voucher	850	850	1	1	1	850
1424104300462	227	80556.0	-1000.0	GMF Dealership Training Discount	VID:1113240097415	Voucher	850	850	1	1	1	850
1424107244707	228	80554.0	-2.0	Dealer Dividend Cash	VID:1113240097515	Voucher	850	850	1	1	1	850
1424110889876	229	79554.0	-1000.0	GMF Dealership Training Discount	VID:1113240097715	Voucher	850	850	1	1	1	850
1424111145172	230	80554.0	1000.0	GMF Dealership Training Discount	VID:1113240097715	Voucher - Void	850	850	1	1	1	850
1424114592662	231	80553.0	-1.0	EOT Excess Mileage Fee Waiver	VID:1113240098115	Voucher	850	850	1	1	1	850
1424118938569	232	80552.0	-1.0	EOT Excess Mileage Fee Waiver	VID:1113240098315	Voucher	850	850	1	1	1	850
1424119305511	233	80052.0	-500.0	GM Accessories Reimbursement	VID:1113240098515	Voucher	850	850	1	1	1	850
1424119409109	234	79717.0	-335.0	XS Wear Premium Reimbursement	VID:1113240098615	Voucher	850	850	1	1	1	850
1424119600381	235	79382.0	-335.0	XS Wear Premium Reimbursement	VID:1113240098715	Voucher	850	850	1	1	1	850
1424119756480	236	79047.0	-335.0	XS Wear Premium Reimbursement	VID:1113240098815	Voucher	850	850	1	1	1	850
1424119760191	237	79547.0	500.0	GM Accessories Reimbursement	VID:1113240098515	Voucher - Void	850	850	1	1	1	850
1424119768317	238	79882.0	335.0	XS Wear Premium Reimbursement	VID:1113240098615	Voucher - Void	850	850	1	1	1	850
1424119778127	239	80217.0	335.0	XS Wear Premium Reimbursement	VID:1113240098715	Voucher - Void	850	850	1	1	1	850
1424119788343	240	80218.0	1.0	EOT Excess Mileage Fee Waiver	VID:1113240097015	Voucher - Void	850	850	1	1	1	850
1424119795492	241	81218.0	1000.0	GMF Dealership Training Discount	VID:1113240097215	Voucher - Void	850	850	1	1	1	850
1424119802950	242	82218.0	1000.0	GMF Dealership Training Discount	VID:1113240097415	Voucher - Void	850	850	1	1	1	850
1424119816801	243	83218.0	1000.0	GMF Dealership Training Discount	VID:1113240096715	Voucher - Void	850	850	1	1	1	850
1424119827584	244	85218.0	2000.0	Retail Down Payment Assistance	VID:1113240094915	Voucher - Void	850	850	1	1	1	850
1424119834728	245	86218.0	1000.0	GMF Dealership Training Discount	VID:1113240092215	Voucher - Void	850	850	1	1	1	850
1424119844874	246	87218.0	1000.0	GMF Dealership Training Discount	VID:1113240092015	Voucher - Void	850	850	1	1	1	850
1424119851789	247	88218.0	1000.0	GMF Dealership Training Discount	VID:1113240093515	Voucher - Void	850	850	1	1	1	850
1424119858518	248	88718.0	500.0	GM Accessories Reimbursement	VID:1113240094515	Voucher - Void	850	850	1	1	1	850
1424119871410	249	89218.0	500.0	Lease CCR	VID:1113240084815	Voucher - Void	850	850	1	1	1	850
1424119878442	250	89718.0	500.0	Retail Down Payment Assistance	VID:1113240084915	Voucher - Void	850	850	1	1	1	850
1424127402900	251	89218.0	-500.0	Lease CCR	VID:1113240098915	Voucher	850	850	1	1	1	850
1424188794524	252	89216.0	-2.0	Dealer Dividend Cash	VID:1113240099015	Voucher	850	850	1	1	1	850
1424188857622	253	89218.0	2.0	Dealer Dividend Cash	VID:1113240099015	Voucher - Void	850	850	1	1	1	850
1424198740776	254	89216.0	-2.0	Dealer Dividend Cash	VID:1113240099315	Voucher	850	850	1	1	1	850
1424199034365	255	89214.0	-2.0	Dealer Dividend Cash	VID:1113240099415	Voucher	850	850	1	1	1	850
1424200533359	256	89212.0	-2.0	Dealer Dividend Cash	VID:1113240100315	Voucher	850	850	1	1	1	850
1424201455219	257	89210.0	-2.0	Dealer Dividend Cash	VID:1113240100615	Voucher	850	850	1	1	1	850
1424204423832	258	89209.0	-1.0	EOT Excess Mileage Fee Waiver	VID:1113240100715	Voucher	850	850	1	1	1	850
1424216058166	259	88840.0	-369.0	CPO Certification Fee Reimbursement	VID:1113240100815	Voucher	850	850	1	1	1	850
1424216638950	260	88505.0	-335.0	XS Wear Premium Reimbursement	VID:1113240100915	Voucher	850	850	1	1	1	850
1424216846393	261	88495.0	-10.0	EOT Excess Mileage Fee Waiver	VID:1113240101015	Voucher	850	850	1	1	1	850
1424217375853	262	88490.0	-5.0	EOT Excess Wear Fee Waiver	VID:1113240101115	Voucher	850	850	1	1	1	850
1424217544732	263	87990.0	-500.0	GMF Dealer Source Vehicle Purchase Rebate	VID:1113240101215	Voucher	850	850	1	1	1	850
1424274792468	264	87988.0	-2.0	Dealer Dividend Cash	VID:1113240101415	Voucher	850	850	1	1	1	850
1424274871875	265	87986.0	-2.0	Dealer Dividend Cash	VID:1113240101515	Voucher	850	850	1	1	1	850
1424345645633	266	87931.0	-55.0	EOT Excess Mileage Fee Waiver	VID:1113240101815	Voucher	850	850	1	1	1	850
1424345808422	267	87933.0	2.0	Dealer Dividend Cash	VID:1113240101515	Voucher - Void	850	850	1	1	1	850
1424368220093	268	87932.0	-1.0	CBCGP - GAP Premium Reimbursement	VID:1113240101915	Voucher	850	850	1	1	1	850
1424368301730	269	87930.0	-2.0	CBCGP - VSC Premium Reimbursement	VID:1113240102015	Voucher	850	850	1	1	1	850
1424368455657	270	87927.0	-3.0	CBCGP  - Tire & Wheel Premium Reimbursement	VID:1113240102215	Voucher	850	850	1	1	1	850
1424368546576	271	87923.0	-4.0	CBCGP - Maintenance Premium Reimbursement	VID:1113240102315	Voucher	850	850	1	1	1	850
1424415902568	272	86423.0	-1500.0	Retail Down Payment Assistance	VID:1113240102715	Voucher	850	850	1	1	1	850
1424421087510	273	87923.0	1500.0	Retail Down Payment Assistance	VID:1113240102715	Voucher - Void	850	850	1	1	1	850
1424421238060	274	81923.0	-6000.0	EOT Excess Mileage Fee Waiver	VID:1113240102815	Voucher	850	850	1	1	1	850
1424425631931	275	82423.0	500.0	Retail Down Payment Assistance	VID:1113240047315	Voucher - Void	850	850	1	1	1	850
1424425631931	276	82923.0	-500.0	Expired Earnings	Jan 2014	Expired Earnings	850	850	1	1	1	850
1424425902459	277	82813.0	-110.0	CBCGP - GAP Premium Reimbursement	VID:1113240103015	Voucher	850	850	1	1	1	850
1424426044929	278	82923.0	110.0	CBCGP - GAP Premium Reimbursement	VID:1113240103015	Voucher - Void	850	850	1	1	1	850
1424426052484	279	88923.0	6000.0	EOT Excess Mileage Fee Waiver	VID:1113240102815	Voucher - Void	850	850	1	1	1	850
1424429060260	280	88823.0	-100.0	Dealer Dividend Cash	VID:1113240103115	Voucher	850	850	1	1	1	850
1424429632540	281	87823.0	-1000.0	GMF Dealership Training Discount	VID:1113240103315	Voucher	850	850	1	1	1	850
1424429803792	282	87923.0	100.0	Dealer Dividend Cash	VID:1113240103115	Voucher - Void	850	850	1	1	1	850
1424431457819	283	87923.0	0.0	EOT Excess Wear Fee Waiver	VID:1113240044315	Voucher - Void	850	850	1	1	1	850
1424431495336	284	87913.0	-10.0	CBCGP - Maintenance Premium Reimbursement	VID:1113240103615	Voucher	850	850	1	1	1	850
1424466489764	285	87911.0	-2.0	Dealer Dividend Cash	VID:1113240104115	Voucher	850	850	1	1	1	850
1424471971534	286	87244.0	-667.0	Dealer Dividend Cash	VID:1113240104315	Voucher	850	850	1	1	1	850
1424663440288	287	87242.0	-2.0	Dealer Dividend Cash	VID:1113240104415	Voucher	850	850	1	1	1	850
1424663587059	288	87239.0	-3.0	Dealer Dividend Cash	VID:1113240104515	Voucher	850	850	1	1	1	850
1424676675466	289	87239.0	0.0	EOT Excess Mileage Fee Waiver	VID:1113240052015	Voucher - Void	850	850	1	1	1	850
1424676703369	290	86813.0	-426.0	CBCGP - VSC Premium Reimbursement	VID:1113240104815	Voucher	850	850	1	1	1	850
1424707461372	291	86811.0	-2.0	Dealer Dividend Cash	VID:1113240105215	Voucher	850	850	1	1	1	850
1424709432816	292	86677.0	-134.0	Dealer Dividend Cash	VID:1113240105315	Voucher	850	850	1	1	1	850
1424710084220	293	86543.0	-134.0	Dealer Dividend Cash	VID:1113240105415	Voucher	850	850	1	1	1	850
1424710133443	294	85543.0	-1000.0	GMF Dealership Training Discount	VID:1113240105615	Voucher	850	850	1	1	1	850
1424711476289	295	84543.0	-1000.0	GMF Dealership Training Discount	VID:1113240105715	Voucher	850	850	1	1	1	850
1424711703718	296	84529.0	-14.0	Dealer Dividend Cash	VID:1113240105815	Voucher	850	850	1	1	1	850
1424729563768	297	85529.0	1000.0	GMF Dealership Training Discount	VID:1113240103315	Voucher - Void	850	850	1	1	1	850
1424730858150	298	85527.0	-2.0	Dealer Dividend Cash	VID:1113240106315	Voucher	850	850	1	1	1	850
1424730885292	299	86194.0	667.0	Dealer Dividend Cash	VID:1113240104315	Voucher - Void	850	850	1	1	1	850
1424730912425	300	86694.0	500.0	GMF DealerSource Vehicle Purchase Rebate	VID:1113240101215	Voucher - Void	850	850	1	1	1	850
1424730969667	301	86695.0	1.0	EOT Excess Mileage Fee Waiver	VID:1113240098115	Voucher - Void	850	850	1	1	1	850
1424731035915	302	87121.0	426.0	CBCGP - VSC Premium Reimbursement	VID:1113240104815	Voucher - Void	850	850	1	1	1	850
1424731041294	303	87123.0	2.0	Dealer Dividend Cash	VID:1113240104115	Voucher - Void	850	850	1	1	1	850
1424731046292	304	87133.0	10.0	CBCGP - Maintenance Premium Reimbursement	VID:1113240103615	Voucher - Void	850	850	1	1	1	850
1424731058703	305	87468.0	335.0	XS Wear Premium Reimbursement	VID:1113240098815	Voucher - Void	850	850	1	1	1	850
1424731063838	306	87968.0	500.0	Lease CCR	VID:1113240098915	Voucher - Void	850	850	1	1	1	850
1424731070455	307	87970.0	2.0	Dealer Dividend Cash	VID:1113240099315	Voucher - Void	850	850	1	1	1	850
1424731078154	308	87972.0	2.0	Dealer Dividend Cash	VID:1113240099415	Voucher - Void	850	850	1	1	1	850
1424731083421	309	87974.0	2.0	Dealer Dividend Cash	VID:1113240100315	Voucher - Void	850	850	1	1	1	850
1424731088438	310	87976.0	2.0	Dealer Dividend Cash	VID:1113240100615	Voucher - Void	850	850	1	1	1	850
1424731099517	311	87977.0	1.0	EOT Excess Mileage Fee Waiver	VID:1113240100715	Voucher - Void	850	850	1	1	1	850
1424731106213	312	88346.0	369.0	CPO Certification Fee Reimbursement	VID:1113240100815	Voucher - Void	850	850	1	1	1	850
1424731110779	313	88681.0	335.0	XS Wear Premium Reimbursement	VID:1113240100915	Voucher - Void	850	850	1	1	1	850
1424731115835	314	88691.0	10.0	EOT Excess Mileage Fee Waiver	VID:1113240101015	Voucher - Void	850	850	1	1	1	850
1424731120508	315	88696.0	5.0	EOT Excess Wear Fee Waiver	VID:1113240101115	Voucher - Void	850	850	1	1	1	850
1424731125949	316	88698.0	2.0	Dealer Dividend Cash	VID:1113240101415	Voucher - Void	850	850	1	1	1	850
1424731130984	317	88753.0	55.0	EOT Excess Mileage Fee Waiver	VID:1113240101815	Voucher - Void	850	850	1	1	1	850
1424731136296	318	88754.0	1.0	CBCGP - GAP Premium Reimbursement	VID:1113240101915	Voucher - Void	850	850	1	1	1	850
1424731143699	319	88756.0	2.0	CBCGP - VSC Premium Reimbursement	VID:1113240102015	Voucher - Void	850	850	1	1	1	850
1424731149018	320	88759.0	3.0	CBCGP  - Tire & Wheel Premium Reimbursement	VID:1113240102215	Voucher - Void	850	850	1	1	1	850
1424731155178	321	88763.0	4.0	CBCGP - Maintenance Premium Reimbursement	VID:1113240102315	Voucher - Void	850	850	1	1	1	850
1424731167044	322	88765.0	2.0	Dealer Dividend Cash	VID:1113240097515	Voucher - Void	850	850	1	1	1	850
1424731189921	323	88767.0	2.0	Dealer Dividend Cash	VID:1113240095015	Voucher - Void	850	850	1	1	1	850
1424731196542	324	88769.0	2.0	Dealer Dividend Cash	VID:1113240096215	Voucher - Void	850	850	1	1	1	850
1424731201244	325	88771.0	2.0	Dealer Dividend Cash	VID:1113240096415	Voucher - Void	850	850	1	1	1	850
1424731206570	326	88773.0	2.0	Dealer Dividend Cash	VID:1113240096615	Voucher - Void	850	850	1	1	1	850
1424731212989	327	88774.0	1.0	EOT Excess Mileage Fee Waiver	VID:1113240098315	Voucher - Void	850	850	1	1	1	850
1424731232873	328	88776.0	2.0	Dealer Dividend Cash	VID:1113240081415	Voucher - Void	850	850	1	1	1	850
1424731237847	329	88836.0	60.0	Dealer Dividend Cash	VID:1113240083515	Voucher - Void	850	850	1	1	1	850
1424731242577	330	88871.0	35.0	Dealer Dividend Cash	VID:1113240083815	Voucher - Void	850	850	1	1	1	850
1424731250316	331	89371.0	500.0	GM Accessories Reimbursement	VID:1113240084115	Voucher - Void	850	850	1	1	1	850
1424731256634	332	89373.0	2.0	Dealer Dividend Cash	VID:1113240084515	Voucher - Void	850	850	1	1	1	850
1424731262572	333	89375.0	2.0	Dealer Dividend Cash	VID:1113240085115	Voucher - Void	850	850	1	1	1	850
1424731267767	334	89710.0	335.0	XS Wear Premium Reimbursement	VID:1113240094815	Voucher - Void	850	850	1	1	1	850
1424731277994	335	89712.0	2.0	Dealer Dividend Cash	VID:1113240075915	Voucher - Void	850	850	1	1	1	850
1424731277994	336	89714.0	-2.0	Expired Earnings	Apr 2014	Expired Earnings	850	850	1	1	1	850
1424731282853	337	89716.0	2.0	Dealer Dividend Cash	VID:1113240076115	Voucher - Void	850	850	1	1	1	850
1424731282853	338	89718.0	-2.0	Expired Earnings	Apr 2014	Expired Earnings	850	850	1	1	1	850
1424731287786	339	89720.0	2.0	Dealer Dividend Cash	VID:1113240076515	Voucher - Void	850	850	1	1	1	850
1424731287786	340	89722.0	-2.0	Expired Earnings	Apr 2014	Expired Earnings	850	850	1	1	1	850
1424731292198	341	89724.0	2.0	Dealer Dividend Cash	VID:1113240076315	Voucher - Void	850	850	1	1	1	850
1424731292198	342	89726.0	-2.0	Expired Earnings	Apr 2014	Expired Earnings	850	850	1	1	1	850
1424731297033	343	89726.0	0.0	Dealer Dividend Cash	VID:1113240078815	Voucher - Void	850	850	1	1	1	850
1424731308312	344	89728.0	2.0	Dealer Dividend Cash	VID:1113240079615	Voucher - Void	850	850	1	1	1	850
1424731319362	345	89729.0	1.0	Dealer Dividend Cash	VID:1113240072415	Voucher - Void	850	850	1	1	1	850
1424731319362	346	89730.0	-1.0	Expired Earnings	Apr 2014	Expired Earnings	850	850	1	1	1	850
1424731326582	347	90730.0	1000.0	GMF Dealership Training Discount	VID:1113240074415	Voucher - Void	850	850	1	1	1	850
1424731326582	348	91730.0	-1000.0	Expired Earnings	Apr 2014	Expired Earnings	850	850	1	1	1	850
1424731333732	349	91743.0	13.0	Dealer Dividend Cash	VID:1113240074315	Voucher - Void	850	850	1	1	1	850
1424731333732	350	91756.0	-13.0	Expired Earnings	Apr 2014	Expired Earnings	850	850	1	1	1	850
1424731338593	351	92022.0	266.0	Dealer Dividend Cash	VID:1113240072515	Voucher - Void	850	850	1	1	1	850
1424731338593	352	92288.0	-266.0	Expired Earnings	Apr 2014	Expired Earnings	850	850	1	1	1	850
1424731343358	353	93288.0	1000.0	GMF Dealership Training Discount	VID:1113240069315	Voucher - Void	850	850	1	1	1	850
1424731343358	354	93317.0	-29.0	Expired Earnings	Feb 2014	Expired Earnings	850	850	1	1	1	850
1424731343358	355	94288.0	-971.0	Expired Earnings	Mar 2014	Expired Earnings	850	850	1	1	1	850
1424731352461	356	94289.0	1.0	Dealer Dividend Cash	VID:1113240068515	Voucher - Void	850	850	1	1	1	850
1424731352461	357	94290.0	-1.0	Expired Earnings	Feb 2014	Expired Earnings	850	850	1	1	1	850
1424733559688	358	94288.0	-2.0	Dealer Dividend Cash	VID:1113240106415	Voucher	850	850	1	1	1	850
1424734306611	359	93288.0	-1000.0	GMF Dealership Training Discount	VID:1113240106515	Voucher	850	850	1	1	1	850
1424736464403	360	93274.0	-14.0	Dealer Dividend Cash	VID:1113240106715	Voucher	850	850	1	1	1	850
1424736803351	361	92774.0	-500.0	GMF DealerSource Vehicle Purchase Rebate	VID:1113240106915	Voucher	850	850	1	1	1	850
1424738091828	362	93274.0	500.0	GMF DealerSource Vehicle Purchase Rebate	VID:1113240106915	Voucher - Void	850	850	1	1	1	850
1424779214210	363	93170.0	-104.0	Dealer Dividend Cash	VID:1113240107115	Voucher	850	850	1	1	1	850
1424790895005	364	92503.0	-667.0	Dealer Dividend Cash	VID:1113240107515	Voucher	850	850	1	1	1	850
1424791682192	365	92501.0	-2.0	Dealer Dividend Cash	VID:1113240107615	Voucher	850	850	1	1	1	850
1424792257958	366	92499.0	-2.0	Dealer Dividend Cash	VID:1113240107715	Voucher	850	850	1	1	1	850
1424792427823	367	92497.0	-2.0	Dealer Dividend Cash	VID:1113240107815	Voucher	850	850	1	1	1	850
1424792532305	368	92495.0	-2.0	Dealer Dividend Cash	VID:1113240107915	Voucher	850	850	1	1	1	850
1424795170908	369	91828.0	-667.0	Dealer Dividend Cash	VID:1113240108015	Voucher	850	850	1	1	1	850
1424795964906	370	91161.0	-667.0	Dealer Dividend Cash	VID:1113240108315	Voucher	850	850	1	1	1	850
1424796097529	371	91160.0	-1.0	EOT Excess Mileage Fee Waiver	VID:1113240108415	Voucher	850	850	1	1	1	850
1424796511387	372	74700.0	-16460.0	Dealer Dividend Cash	VID:1113240108515	Voucher	850	850	1	1	1	850
1424796622854	373	68938.0	-5762.0	Dealer Dividend Cash	VID:1113240108715	Voucher	850	850	1	1	1	850
1424797577978	374	68936.0	-2.0	Dealer Dividend Cash	VID:1113240108815	Voucher	850	850	1	1	1	850
1424797645272	375	68934.0	-2.0	Dealer Dividend Cash	VID:1113240108915	Voucher	850	850	1	1	1	850
1424797744344	376	68932.0	-2.0	Dealer Dividend Cash	VID:1113240109015	Voucher	850	850	1	1	1	850
1424799297136	377	68620.0	-312.0	Dealer Dividend Cash	VID:1113240109315	Voucher	850	850	1	1	1	850
1424799334007	378	68026.0	-594.0	Dealer Dividend Cash	VID:1113240109415	Voucher	850	850	1	1	1	850
1424799413116	379	68025.0	-1.0	CBCGP  - Tire & Wheel Premium Reimbursement	VID:1113240109215	Voucher	850	850	1	1	1	850
1424800329780	380	67525.0	-500.0	GM Accessories Reimbursement	VID:1113240109615	Voucher	850	850	1	1	1	850
1424801215142	381	67509.0	-16.0	Dealer Dividend Cash	VID:1113240110015	Voucher	850	850	1	1	1	850
1424801335458	382	67508.0	-1.0	CBCGP  - Tire & Wheel Premium Reimbursement	VID:1113240110115	Voucher	850	850	1	1	1	850
1424801446585	383	67509.0	1.0	CBCGP  - Tire & Wheel Premium Reimbursement	VID:1113240110115	Voucher - Void	850	850	1	1	1	850
1424806984319	384	66509.0	-1000.0	GMF Dealership Training Discount	VID:1113240110215	Voucher	850	850	1	1	1	850
1424809989414	385	66508.0	-1.0	EOT Excess Mileage Fee Waiver	VID:1113240110915	Voucher	850	850	1	1	1	850
1424810026720	386	66509.0	1.0	EOT Excess Mileage Fee Waiver	VID:1113240110915	Voucher - Void	850	850	1	1	1	850
1424812690269	387	66009.0	-500.0	GMF DealerSource Vehicle Purchase Rebate	VID:1113240111615	Voucher	850	850	1	1	1	850
1424812815745	388	66509.0	500.0	GMF DealerSource Vehicle Purchase Rebate	VID:1113240111615	Voucher - Void	850	850	1	1	1	850
1424849250870	389	65509.0	-1000.0	Retail Down Payment Assistance	VID:1113240111915	Voucher	850	850	1	1	1	850
1424879869779	390	65507.0	-2.0	Dealer Dividend Cash	VID:1113240112015	Voucher	850	850	1	1	1	850
1424880048999	391	65506.0	-1.0	EOT Excess Mileage Fee Waiver	VID:1113240112115	Voucher	850	850	1	1	1	850
1424880899611	392	65504.0	-2.0	Dealer Dividend Cash	VID:1113240112315	Voucher	850	850	1	1	1	850
1424896057861	393	66004.0	500.0	GM Accessories Reimbursement	VID:1113240109615	Voucher - Void	850	850	1	1	1	850
1424896142742	394	67004.0	1000.0	Retail Down Payment Assistance	VID:1113240111915	Voucher - Void	850	850	1	1	1	850
1424896231674	395	68004.0	1000.0	GMF Dealership Training Discount	VID:1113240069215	Voucher - Void	850	850	1	1	1	850
1424896231674	396	69004.0	-1000.0	Expired Earnings	Mar 2014	Expired Earnings	850	850	1	1	1	850
1424896281150	397	69339.0	335.0	XS Wear Premium Reimbursement	VID:1113240094815	Voucher - Void	850	850	1	1	1	850
1424896311528	398	69472.0	133.0	Dealer Dividend Cash	VID:1113240068315	Voucher - Void	850	850	1	1	1	850
1424896311528	399	69605.0	-133.0	Expired Earnings	Feb 2014	Expired Earnings	850	850	1	1	1	850
1424896407513	400	69604.0	-1.0	CBCGP - Maintenance Premium Reimbursement	VID:1113240112615	Voucher	850	850	1	1	1	850
1424896493194	401	69605.0	1.0	CBCGP - Maintenance Premium Reimbursement	VID:1113240112615	Voucher - Void	850	850	1	1	1	850
1424896559964	402	68657.0	-948.0	CBCGP - VSC Premium Reimbursement	VID:1113240112715	Voucher	850	850	1	1	1	850
1424896945868	403	69605.0	948.0	CBCGP - VSC Premium Reimbursement	VID:1113240112715	Voucher - Void	850	850	1	1	1	850
1424897040627	404	58657.0	-10948.0	CBCGP - Maintenance Premium Reimbursement	VID:1113240112815	Voucher	850	850	1	1	1	850
1424897202783	405	69605.0	10948.0	CBCGP - Maintenance Premium Reimbursement	VID:1113240112815	Voucher - Void	850	850	1	1	1	850
1424925760805	406	69604.0	-1.0	EOT Excess Mileage Fee Waiver	VID:1113240112915	Voucher	850	850	1	1	1	850
1424925868945	407	69605.0	1.0	EOT Excess Mileage Fee Waiver	VID:1113240112915	Voucher - Void	850	850	1	1	1	850
1424952824534	408	68605.0	-1000.0	Dealer Dividend Cash	VID:1113240113115	Voucher	850	850	1	1	1	850
1424954845109	409	68557.0	-48.0	EOT Excess Mileage Fee Waiver	VID:1113240113215	Voucher	850	850	1	1	1	850
1424954911536	410	68605.0	48.0	EOT Excess Mileage Fee Waiver	VID:1113240113215	Voucher - Void	850	850	1	1	1	850
1424965713506	411	68604.0	-1.0	EOT Excess Wear Fee Waiver	VID:1113240113415	Voucher	850	850	1	1	1	850
1424965770382	412	68605.0	1.0	EOT Excess Wear Fee Waiver	VID:1113240113415	Voucher - Void	850	850	1	1	1	850
1424966543793	413	68604.0	-1.0	EOT Excess Mileage Fee Waiver	VID:1113240113515	Voucher	850	850	1	1	1	850
1424967707789	414	68269.0	-335.0	XS Wear Premium Reimbursement	VID:1113240113615	Voucher	850	850	1	1	1	850
1424967864355	415	67934.0	-335.0	XS Wear Premium Reimbursement	VID:1113240113715	Voucher	850	850	1	1	1	850
1424972595941	416	68269.0	335.0	XS Wear Premium Reimbursement	VID:1113240113715	Voucher - Void	850	850	1	1	1	850
1424972608645	417	68604.0	335.0	XS Wear Premium Reimbursement	VID:1113240113615	Voucher - Void	850	850	1	1	1	850
1424972651498	418	68605.0	1.0	EOT Excess Mileage Fee Waiver	VID:1113240113515	Voucher - Void	850	850	1	1	1	850
1424972659397	419	68606.0	1.0	EOT Excess Mileage Fee Waiver	VID:1113240108415	Voucher - Void	850	850	1	1	1	850
1424973412535	420	68595.0	-11.0	EOT Excess Mileage Fee Waiver	VID:1113240113915	Voucher	850	850	1	1	1	850
1424973524228	421	68606.0	11.0	EOT Excess Mileage Fee Waiver	VID:1113240113915	Voucher - Void	850	850	1	1	1	850
1424973617029	422	58657.0	-9949.0	CBCGP  - Tire & Wheel Premium Reimbursement	VID:1113240114015	Voucher	850	850	1	1	1	850
1424973714089	423	68606.0	9949.0	CBCGP  - Tire & Wheel Premium Reimbursement	VID:1113240114015	Voucher - Void	850	850	1	1	1	850
1424974534994	424	67604.0	-1002.0	CBCGP  - Tire & Wheel Premium Reimbursement	VID:1113240114215	Voucher	850	850	1	1	1	850
1424974624392	425	68606.0	1002.0	CBCGP  - Tire & Wheel Premium Reimbursement	VID:1113240114215	Voucher - Void	850	850	1	1	1	850
1424984566115	426	68106.0	-500.0	Retail Down Payment Assistance	VID:1113240114315	Voucher	850	850	1	1	1	850
1424985430082	427	67606.0	-500.0	Lease CCR	VID:1113240114515	Voucher	850	850	1	1	1	850
1424985445204	428	67187.0	-419.0	CPO Certification Fee Reimbursement	VID:1113240114615	Voucher	850	850	1	1	1	850
1424985513424	429	67176.0	-11.0	EOT Excess Mileage Fee Waiver	VID:1113240114715	Voucher	850	850	1	1	1	850
1424985962865	430	66841.0	-335.0	XS Wear Premium Reimbursement	VID:1113240114815	Voucher	850	850	1	1	1	850
1424985986417	431	66829.0	-12.0	EOT Excess Wear Fee Waiver	VID:1113240114915	Voucher	850	850	1	1	1	850
1424986015766	432	66816.0	-13.0	CBCGP - GAP Premium Reimbursement	VID:1113240115015	Voucher	850	850	1	1	1	850
1424986053120	433	66802.0	-14.0	CBCGP - VSC Premium Reimbursement	VID:1113240115115	Voucher	850	850	1	1	1	850
1424986082347	434	66787.0	-15.0	CBCGP  - Tire & Wheel Premium Reimbursement	VID:1113240115215	Voucher	850	850	1	1	1	850
1424986106927	435	66771.0	-16.0	CBCGP - Maintenance Premium Reimbursement	VID:1113240115315	Voucher	850	850	1	1	1	850
1424986128664	436	66271.0	-500.0	GMF DealerSource Vehicle Purchase Rebate	VID:1113240115415	Voucher	850	850	1	1	1	850
1424986169733	437	65771.0	-500.0	GMF DealerSource Vehicle Purchase Rebate	VID:1113240115515	Voucher	850	850	1	1	1	850
1424986215808	438	64771.0	-1000.0	GMF Dealership Training Discount	VID:1113240115615	Voucher	850	850	1	1	1	850
1424986233631	439	64271.0	-500.0	GM Accessories Reimbursement	VID:1113240115715	Voucher	850	850	1	1	1	850
1424986263850	440	64248.0	-23.0	Dealer Dividend Cash	VID:1113240115815	Voucher	850	850	1	1	1	850
1424988935692	441	64234.0	-14.0	Dealer Dividend Cash	VID:1113240115915	Voucher	850	850	1	1	1	850
1424991280055	442	7077.0	500.0	GM Accessories Reimbursement	VID:1113240115715	Voucher - Void	850	850	1	1	1	850
1424991371013	443	7577.0	500.0	GMF DealerSource Vehicle Purchase Rebate	VID:1113240115515	Voucher - Void	850	850	1	1	1	850
1424991543766	444	7591.0	14.0	CBCGP - VSC Premium Reimbursement	VID:1113240115115	Voucher - Void	850	850	1	1	1	850
1424991549462	445	7606.0	15.0	CBCGP  - Tire & Wheel Premium Reimbursement	VID:1113240115215	Voucher - Void	850	850	1	1	1	850
1424991554656	446	7622.0	16.0	CBCGP - Maintenance Premium Reimbursement	VID:1113240115315	Voucher - Void	850	850	1	1	1	850
1424991560083	447	8122.0	500.0	GMF DealerSource Vehicle Purchase Rebate	VID:1113240115415	Voucher - Void	850	850	1	1	1	850
1424991579599	448	8135.0	13.0	CBCGP - GAP Premium Reimbursement	VID:1113240115015	Voucher - Void	850	850	1	1	1	850
1424991585332	449	8147.0	12.0	EOT Excess Wear Fee Waiver	VID:1113240114915	Voucher - Void	850	850	1	1	1	850
1424991589741	450	8482.0	335.0	XS Wear Premium Reimbursement	VID:1113240114815	Voucher - Void	850	850	1	1	1	850
1424991594689	451	8493.0	11.0	EOT Excess Mileage Fee Waiver	VID:1113240114715	Voucher - Void	850	850	1	1	1	850
1424991601244	452	8912.0	419.0	CPO Certification Fee Reimbursement	VID:1113240114615	Voucher - Void	850	850	1	1	1	850
1424991607139	453	9412.0	500.0	Lease CCR	VID:1113240114515	Voucher - Void	850	850	1	1	1	850
1424991611584	454	9912.0	500.0	Retail Down Payment Assistance	VID:1113240114315	Voucher - Void	850	850	1	1	1	850
1425022896301	455	9577.0	-335.0	XS Wear Premium Reimbursement	VID:1113240116015	Voucher	850	850	1	1	1	850
1425023584718	456	9912.0	335.0	XS Wear Premium Reimbursement	VID:1113240116015	Voucher - Void	850	850	1	1	1	850
1425065407126	457	9908.0	-4.0	Dealer Dividend Cash	VID:1113240117215	Voucher	850	850	1	1	1	850
1425189686620	458	9908.0	0.0	Expired Earnings	Dec 2014	Expired Earnings	850	850	1	1	1	850
1425189686620	459	8883.0	-1025.0	Expired Earnings	Jan 2014	Expired Earnings	850	850	1	1	1	850
1425189686620	460	8408.0	-1500.0	Expired Earnings	Feb 2014	Expired Earnings	850	850	1	1	1	850
1425189686620	461	4908.0	-5000.0	Expired Earnings	Mar 2014	Expired Earnings	850	850	1	1	1	850
1425189686620	462	4908.0	-5000.0	Expired Earnings	Apr 2014	Expired Earnings	850	850	1	1	1	850
1425294930753	463	9458.0	-450.0	CBCGP  - Tire & Wheel Premium Reimbursement	VID:1113240117915	Voucher	850	850	1	1	1	850
1425310762910	464	8958.0	-500.0	GM Accessories Reimbursement	VID:1113240118015	Voucher	850	850	1	1	1	850
1425314505470	465	8957.0	-1.0	EOT Excess Wear Fee Waiver	VID:1113240118115	Voucher	850	850	1	1	1	850
1425314576909	466	8958.0	1.0	EOT Excess Wear Fee Waiver	VID:1113240118115	Voucher - Void	850	850	1	1	1	850
1425315167024	467	8948.0	-10.0	CBCGP  - Tire & Wheel Premium Reimbursement	VID:1113240118215	Voucher	850	850	1	1	1	850
1425315447469	468	8945.0	-3.0	EOT Excess Mileage Fee Waiver	VID:1113240118315	Voucher	850	850	1	1	1	850
1425315883170	469	8948.0	3.0	EOT Excess Mileage Fee Waiver	VID:1113240118315	Voucher - Void	850	850	1	1	1	850
1425316011027	470	8909.0	-39.0	CBCGP - GAP Premium Reimbursement	VID:1113240118415	Voucher	850	850	1	1	1	850
1425317639573	471	9359.0	450.0	CBCGP  - Tire & Wheel Premium Reimbursement	VID:1113240117915	Voucher - Void	850	850	1	1	1	850
1425317646397	472	9859.0	500.0	GM Accessories Reimbursement	VID:1113240118015	Voucher - Void	850	850	1	1	1	850
1425317653663	473	9869.0	10.0	CBCGP  - Tire & Wheel Premium Reimbursement	VID:1113240118215	Voucher - Void	850	850	1	1	1	850
1425317806017	474	9864.0	-5.0	CBCGP - VSC Premium Reimbursement	VID:1113240118515	Voucher	850	850	1	1	1	850
1425444149816	475	9824.0	-40.0	CBCGP - VSC Premium Reimbursement	VID:1113240118615	Voucher	850	850	1	1	1	850
1425483347384	476	9822.0	-2.0	Dealer Dividend Cash	VID:1113240118915	Voucher	850	850	1	1	1	850
1425495574143	477	9322.0	-500.0	Expired Earnings	Jan 2014	Expired Earnings	850	850	1	1	1	850
1425495574143	478	8322.0	-1000.0	Expired Earnings	Jan 2014	Expired Earnings	850	850	1	1	1	850
1425495574143	479	7822.0	-500.0	Expired Earnings	Jan 2014	Expired Earnings	850	850	1	1	1	850
1425495574143	480	6822.0	-1000.0	Expired Earnings	Jan 2014	Expired Earnings	850	850	1	1	1	850
1425495574143	481	5822.0	-1000.0	Expired Earnings	Jan 2014	Expired Earnings	850	850	1	1	1	850
1425495574143	482	5322.0	-500.0	Expired Earnings	Jan 2014	Expired Earnings	850	850	1	1	1	850
1425495574143	483	4987.0	-335.0	Expired Earnings	Jan 2014	Expired Earnings	850	850	1	1	1	850
1425495574143	484	4487.0	-500.0	Expired Earnings	Feb 2014	Expired Earnings	850	850	1	1	1	850
1425495574143	485	3487.0	-1000.0	Expired Earnings	Feb 2014	Expired Earnings	850	850	1	1	1	850
1425495574143	486	2487.0	-1000.0	Expired Earnings	Feb 2014	Expired Earnings	850	850	1	1	1	850
1425495574143	487	1487.0	-1000.0	Expired Earnings	Feb 2014	Expired Earnings	850	850	1	1	1	850
1425571964453	488	1987.0	500.0	GMF DealerSource Vehicle Purchase Rebate	VID:1113240037615	Voucher - Invalid	850	850	1	1	1	850
1425571964453	489	2987.0	1000.0	GMF Dealership Training Discount	VID:1113240038715	Voucher - Invalid	850	850	1	1	1	850
1425571964453	490	3487.0	500.0	GM Accessories Reimbursement	VID:1113240041115	Voucher - Invalid	850	850	1	1	1	850
1425571964453	491	4487.0	1000.0	GMF Dealership Training Discount	VID:1113240043015	Voucher - Invalid	850	850	1	1	1	850
1425571964453	492	5487.0	1000.0	GMF Dealership Training Discount	VID:1113240043115	Voucher - Invalid	850	850	1	1	1	850
1425571964453	493	5987.0	500.0	GMF DealerSource Vehicle Purchase Rebate	VID:1113240043315	Voucher - Invalid	850	850	1	1	1	850
1425571964453	494	6322.0	335.0	XS Wear Premium Reimbursement	VID:1113240044515	Voucher - Invalid	850	850	1	1	1	850
1425571964453	495	6822.0	500.0	Retail Down Payment Assistance	VID:1113240049015	Voucher - Invalid	850	850	1	1	1	850
1425571964453	496	7822.0	1000.0	GMF Dealership Training Discount	VID:1113240052615	Voucher - Invalid	850	850	1	1	1	850
1425571964453	497	8822.0	1000.0	GMF Dealership Training Discount	VID:1113240058615	Voucher - Invalid	850	850	1	1	1	850
1425571964453	498	9822.0	1000.0	GMF Dealership Training Discount	VID:1113240060515	Voucher - Invalid	850	850	1	1	1	850
1425571964453	499	9823.0	1.0	CBCGP  - Tire & Wheel Premium Reimbursement	VID:1113240109215	Voucher - Invalid	850	850	1	1	1	850
1425571964453	500	9824.0	1.0	EOT Excess Mileage Fee Waiver	VID:1113240112115	Voucher - Invalid	850	850	1	1	1	850
1425571964453	501	9861.0	37.0	CBCGP - GAP Premium Reimbursement	VID:1113240118415	Voucher - Invalid	850	850	1	1	1	850
1425571964453	502	9863.0	2.0	CBCGP - GAP Premium Reimbursement	VID:1113240118415	Voucher - Invalid	850	850	1	1	1	850
1425571964530	503	9363.0	-500.0	Expired Earnings	Jan 2014	Expired Earnings	850	850	1	1	1	850
1425571964530	504	8363.0	-1000.0	Expired Earnings	Jan 2014	Expired Earnings	850	850	1	1	1	850
1425571964530	505	7863.0	-500.0	Expired Earnings	Jan 2014	Expired Earnings	850	850	1	1	1	850
1425571964530	506	6863.0	-1000.0	Expired Earnings	Jan 2014	Expired Earnings	850	850	1	1	1	850
1425571964530	507	5863.0	-1000.0	Expired Earnings	Jan 2014	Expired Earnings	850	850	1	1	1	850
1425571964530	508	5363.0	-500.0	Expired Earnings	Jan 2014	Expired Earnings	850	850	1	1	1	850
1425571964530	509	5028.0	-335.0	Expired Earnings	Jan 2014	Expired Earnings	850	850	1	1	1	850
1425571964530	510	4528.0	-500.0	Expired Earnings	Feb 2014	Expired Earnings	850	850	1	1	1	850
1425571964530	511	3528.0	-1000.0	Expired Earnings	Feb 2014	Expired Earnings	850	850	1	1	1	850
1425571964530	512	2528.0	-1000.0	Expired Earnings	Feb 2014	Expired Earnings	850	850	1	1	1	850
1425571964530	513	1528.0	-1000.0	Expired Earnings	Feb 2014	Expired Earnings	850	850	1	1	1	850
1425572031697	514	2028.0	500.0	GMF DealerSource Vehicle Purchase Rebate	VID:1113240037615	Voucher - Invalid	850	850	1	1	1	850
1425572031697	515	3028.0	1000.0	GMF Dealership Training Discount	VID:1113240038715	Voucher - Invalid	850	850	1	1	1	850
1425572031697	516	3528.0	500.0	GM Accessories Reimbursement	VID:1113240041115	Voucher - Invalid	850	850	1	1	1	850
1425572031697	517	4528.0	1000.0	GMF Dealership Training Discount	VID:1113240043015	Voucher - Invalid	850	850	1	1	1	850
1425572031697	518	5528.0	1000.0	GMF Dealership Training Discount	VID:1113240043115	Voucher - Invalid	850	850	1	1	1	850
1425572031697	519	6028.0	500.0	GMF DealerSource Vehicle Purchase Rebate	VID:1113240043315	Voucher - Invalid	850	850	1	1	1	850
1425572031697	520	6363.0	335.0	XS Wear Premium Reimbursement	VID:1113240044515	Voucher - Invalid	850	850	1	1	1	850
1425572031697	521	6863.0	500.0	Retail Down Payment Assistance	VID:1113240049015	Voucher - Invalid	850	850	1	1	1	850
1425572031697	522	7863.0	1000.0	GMF Dealership Training Discount	VID:1113240052615	Voucher - Invalid	850	850	1	1	1	850
1425572031697	523	8863.0	1000.0	GMF Dealership Training Discount	VID:1113240058615	Voucher - Invalid	850	850	1	1	1	850
1425572031697	524	9863.0	1000.0	GMF Dealership Training Discount	VID:1113240060515	Voucher - Invalid	850	850	1	1	1	850
1425572031697	525	9864.0	1.0	CBCGP  - Tire & Wheel Premium Reimbursement	VID:1113240109215	Voucher - Invalid	850	850	1	1	1	850
1425572031697	526	9865.0	1.0	EOT Excess Mileage Fee Waiver	VID:1113240112115	Voucher - Invalid	850	850	1	1	1	850
1425572031697	527	9902.0	37.0	CBCGP - GAP Premium Reimbursement	VID:1113240118415	Voucher - Invalid	850	850	1	1	1	850
1425572031697	528	9904.0	2.0	CBCGP - GAP Premium Reimbursement	VID:1113240118415	Voucher - Invalid	850	850	1	1	1	850
1425572031760	529	9404.0	-500.0	Expired Earnings	Jan 2014	Expired Earnings	850	850	1	1	1	850
1425572031760	530	8404.0	-1000.0	Expired Earnings	Jan 2014	Expired Earnings	850	850	1	1	1	850
1425572031760	531	7904.0	-500.0	Expired Earnings	Jan 2014	Expired Earnings	850	850	1	1	1	850
1425572031760	532	6904.0	-1000.0	Expired Earnings	Jan 2014	Expired Earnings	850	850	1	1	1	850
1425572031760	533	5904.0	-1000.0	Expired Earnings	Jan 2014	Expired Earnings	850	850	1	1	1	850
1425572031760	534	5404.0	-500.0	Expired Earnings	Jan 2014	Expired Earnings	850	850	1	1	1	850
1425572031760	535	5069.0	-335.0	Expired Earnings	Jan 2014	Expired Earnings	850	850	1	1	1	850
1425572031760	536	4569.0	-500.0	Expired Earnings	Feb 2014	Expired Earnings	850	850	1	1	1	850
1425572031760	537	3569.0	-1000.0	Expired Earnings	Feb 2014	Expired Earnings	850	850	1	1	1	850
1425572031760	538	2569.0	-1000.0	Expired Earnings	Feb 2014	Expired Earnings	850	850	1	1	1	850
1425572031760	539	1569.0	-1000.0	Expired Earnings	Feb 2014	Expired Earnings	850	850	1	1	1	850
1425572382277	540	2069.0	500.0	GMF DealerSource Vehicle Purchase Rebate	VID:1113240037615	Voucher - Invalid	850	850	1	1	1	850
1425572382277	541	3069.0	1000.0	GMF Dealership Training Discount	VID:1113240038715	Voucher - Invalid	850	850	1	1	1	850
1425572382277	542	3569.0	500.0	GM Accessories Reimbursement	VID:1113240041115	Voucher - Invalid	850	850	1	1	1	850
1425572382277	543	4569.0	1000.0	GMF Dealership Training Discount	VID:1113240043015	Voucher - Invalid	850	850	1	1	1	850
1425572382277	544	5569.0	1000.0	GMF Dealership Training Discount	VID:1113240043115	Voucher - Invalid	850	850	1	1	1	850
1425572382277	545	6069.0	500.0	GMF DealerSource Vehicle Purchase Rebate	VID:1113240043315	Voucher - Invalid	850	850	1	1	1	850
1425572382277	546	6404.0	335.0	XS Wear Premium Reimbursement	VID:1113240044515	Voucher - Invalid	850	850	1	1	1	850
1425572382277	547	6904.0	500.0	Retail Down Payment Assistance	VID:1113240049015	Voucher - Invalid	850	850	1	1	1	850
1425572382277	548	7904.0	1000.0	GMF Dealership Training Discount	VID:1113240052615	Voucher - Invalid	850	850	1	1	1	850
1425572382277	549	8904.0	1000.0	GMF Dealership Training Discount	VID:1113240058615	Voucher - Invalid	850	850	1	1	1	850
1425572382277	550	9904.0	1000.0	GMF Dealership Training Discount	VID:1113240060515	Voucher - Invalid	850	850	1	1	1	850
1425572382277	551	9905.0	1.0	CBCGP  - Tire & Wheel Premium Reimbursement	VID:1113240109215	Voucher - Invalid	850	850	1	1	1	850
1425572382277	552	9906.0	1.0	EOT Excess Mileage Fee Waiver	VID:1113240112115	Voucher - Invalid	850	850	1	1	1	850
1425572382277	553	9943.0	37.0	CBCGP - GAP Premium Reimbursement	VID:1113240118415	Voucher - Invalid	850	850	1	1	1	850
1425572382277	554	9945.0	2.0	CBCGP - GAP Premium Reimbursement	VID:1113240118415	Voucher - Invalid	850	850	1	1	1	850
1425572382307	555	9445.0	-500.0	Expired Earnings	Jan 2014	Expired Earnings	850	850	1	1	1	850
1425572382307	556	8445.0	-1000.0	Expired Earnings	Jan 2014	Expired Earnings	850	850	1	1	1	850
1425572382307	557	7945.0	-500.0	Expired Earnings	Jan 2014	Expired Earnings	850	850	1	1	1	850
1425572382307	558	6945.0	-1000.0	Expired Earnings	Jan 2014	Expired Earnings	850	850	1	1	1	850
1425572382307	559	5945.0	-1000.0	Expired Earnings	Jan 2014	Expired Earnings	850	850	1	1	1	850
1425572382307	560	5445.0	-500.0	Expired Earnings	Jan 2014	Expired Earnings	850	850	1	1	1	850
1425572382307	561	5110.0	-335.0	Expired Earnings	Jan 2014	Expired Earnings	850	850	1	1	1	850
1425572382307	562	4610.0	-500.0	Expired Earnings	Feb 2014	Expired Earnings	850	850	1	1	1	850
1425572382307	563	3610.0	-1000.0	Expired Earnings	Feb 2014	Expired Earnings	850	850	1	1	1	850
1425572382307	564	2610.0	-1000.0	Expired Earnings	Feb 2014	Expired Earnings	850	850	1	1	1	850
1425572382307	565	1610.0	-1000.0	Expired Earnings	Feb 2014	Expired Earnings	850	850	1	1	1	850
1425901757256	566	9972.0	-14.0	Dealer Dividend Cash	VID:1113240119115	Voucher	850	850	1	1	1	850
1426239197911	567	9822.0	-150.0	Dealer Dividend Cash	VID:1113240119415	Voucher	850	850	1	1	1	850
1426498846811	568	9862.0	40.0	CBCGP - VSC Premium Reimbursement	VID:1113240118615	Voucher - Void	850	850	1	1	1	850
1426498877243	569	9462.0	-400.0	EOT Excess Mileage Fee Waiver	VID:1113240119915	Voucher	850	850	1	1	1	850
1426498932461	570	8462.0	-1000.0	Retail Down Payment Assistance	VID:1113240120115	Voucher	850	850	1	1	1	850
1426505747325	571	9462.0	1000.0	Retail Down Payment Assistance	VID:1113240120115	Voucher - Void	850	850	1	1	1	850
1426747555903	572	8962.0	-500.0	Retail Down Payment Assistance	VID:1113240121315	Voucher	850	850	1	1	1	850
1426748574825	573	9462.0	500.0	Retail Down Payment Assistance	VID:1113240121315	Voucher - Void	850	850	1	1	1	850
1426751801922	574	7462.0	-2000.0	Lease CCR	VID:1113240121515	Voucher	850	850	1	1	1	850
1426752178229	575	9462.0	2000.0	Lease CCR	VID:1113240121515	Voucher - Void	850	850	1	1	1	850
1426754664006	576	9127.0	-335.0	XS Wear Premium Reimbursement	VID:1113240121615	Voucher	850	850	1	1	1	850
1426754769161	577	9462.0	335.0	XS Wear Premium Reimbursement	VID:1113240121615	Voucher - Void	850	850	1	1	1	850
1426754861185	578	8962.0	-500.0	Lease CCR	VID:1113240121715	Voucher	850	850	1	1	1	850
1426755572995	579	9462.0	500.0	Lease CCR	VID:1113240121715	Voucher - Void	850	850	1	1	1	850
1426755614191	580	8462.0	-1000.0	GMF Dealership Training Discount	VID:1113240121815	Voucher	850	850	1	1	1	850
1426780868465	581	8461.0	-1.0	EOT Excess Mileage Fee Waiver	VID:1113240122015	Voucher	850	850	1	1	1	850
1426781368411	582	8460.0	-1.0	CBCGP - GAP Premium Reimbursement	VID:1113240122115	Voucher	850	850	1	1	1	850
1426848742953	583	7960.0	-500.0	Retail Down Payment Assistance	VID:1113240122215	Voucher	850	850	1	1	1	850
1427091701370	584	7950.0	-10.0	EOT Excess Mileage Fee Waiver	VID:1113240122315	Voucher	850	850	1	1	1	850
1427091782213	585	7960.0	10.0	EOT Excess Mileage Fee Waiver	VID:1113240122315	Voucher - Void	850	850	1	1	1	850
1427094224259	586	7460.0	-500.0	Retail Down Payment Assistance	VID:1113240122415	Voucher	850	850	1	1	1	850
1427094346572	587	6960.0	-500.0	Lease CCR	VID:1113240122515	Voucher	850	850	1	1	1	850
1427094396081	588	6541.0	-419.0	CPO Certification Fee Reimbursement	VID:1113240122615	Voucher	850	850	1	1	1	850
1427094642636	589	6206.0	-335.0	XS Wear Premium Reimbursement	VID:1113240122915	Voucher	850	850	1	1	1	850
1427095273002	590	6706.0	500.0	Retail Down Payment Assistance	VID:1113240122415	Voucher - Void	850	850	1	1	1	850
1427095281678	591	7206.0	500.0	Lease CCR	VID:1113240122515	Voucher - Void	850	850	1	1	1	850
1427095288465	592	7625.0	419.0	CPO Certification Fee Reimbursement	VID:1113240122615	Voucher - Void	850	850	1	1	1	850
1427095295828	593	7960.0	335.0	XS Wear Premium Reimbursement	VID:1113240122915	Voucher - Void	850	850	1	1	1	850
1427095671077	594	8460.0	500.0	Retail Down Payment Assistance	VID:1113240122215	Voucher - Void	850	850	1	1	1	850
1427095965048	595	8300.0	-160.0	Dealer Dividend Cash	VID:1113240123015	Voucher	850	850	1	1	1	850
1427096174692	596	7300.0	-1000.0	GMF Dealership Training Discount	VID:1113240123115	Voucher	850	850	1	1	1	850
1427126824899	597	7299.0	-1.0	EOT Excess Mileage Fee Waiver	VID:1113240123415	Voucher	850	850	1	1	1	850
1427231193098	598	7298.0	-1.0	CBCGP  - Tire & Wheel Premium Reimbursement	VID:1113240123515	Voucher	850	850	1	1	1	850
1427233468662	599	7296.0	-2.0	Dealer Dividend Cash	VID:1113240123615	Voucher	850	850	1	1	1	850
1427235058913	600	5796.0	-1500.0	Lease CCR	VID:1113240123915	Voucher	850	850	1	1	1	850
1427235166921	601	7296.0	1500.0	Lease CCR	VID:1113240123915	Voucher - Void	850	850	1	1	1	850
1427487766747	602	7295.0	-1.0	EOT Excess Mileage Fee Waiver	VID:1113240124115	Voucher	850	850	1	1	1	850
1427494017695	603	7294.0	-1.0	CBCGP - GAP Premium Reimbursement	VID:1113240124215	Voucher	850	850	1	1	1	850
1427793828398	604	6294.0	-1000.0	Retail Down Payment Assistance	VID:1113240124815	Voucher	850	850	1	1	1	850
1427794182181	605	6284.0	-10.0	EOT Excess Wear Fee Waiver	VID:1113240125215	Voucher	850	850	1	1	1	850
1427800291623	606	6268.0	-16.0	Dealer Dividend Cash	VID:1113240125315	Voucher	850	850	1	1	1	850
1427819031213	607	6267.0	-1.0	EOT Excess Mileage Fee Waiver	VID:1113240125415	Voucher	850	850	1	1	1	850
1427819057188	608	6268.0	1.0	CBCGP - GAP Premium Reimbursement	VID:1113240124215	Voucher - Void	850	850	1	1	1	850
1427829723481	609	6267.0	-1.0	EOT Excess Mileage Fee Waiver	VID:1113240125515	Voucher	850	850	1	1	1	850
1427836146719	610	6266.0	-1.0	CBCGP  - Tire & Wheel Premium Reimbursement	VID:1113240125715	Voucher	850	850	1	1	1	850
1427840666925	611	6267.0	1.0	CBCGP - GAP Premium Reimbursement	VID:1113240122115	Voucher - Void	850	850	1	1	1	850
1427840674138	612	6268.0	1.0	EOT Excess Mileage Fee Waiver	VID:1113240122015	Voucher - Void	850	850	1	1	1	850
1427840679596	613	6668.0	400.0	EOT Excess Mileage Fee Waiver	VID:1113240119915	Voucher - Void	850	850	1	1	1	850
1427840690984	614	6669.0	1.0	EOT Excess Mileage Fee Waiver	VID:1113240124115	Voucher - Void	850	850	1	1	1	850
1427840695710	615	6670.0	1.0	CBCGP  - Tire & Wheel Premium Reimbursement	VID:1113240123515	Voucher - Void	850	850	1	1	1	850
1427840701836	616	6671.0	1.0	EOT Excess Mileage Fee Waiver	VID:1113240123415	Voucher - Void	850	850	1	1	1	850
1427840763657	617	6670.0	-1.0	CBCGP - GAP Premium Reimbursement	VID:1113240125915	Voucher	850	850	1	1	1	850
1427841521815	618	6669.0	-1.0	CBCGP - Maintenance Premium Reimbursement	VID:1113240126015	Voucher	850	850	1	1	1	850
1427864478430	619	6271.0	-398.0	Expired Earnings	Jan 2015	Expired Earnings	850	850	1	1	1	850
1427877794769	620	6200.0	-71.0	CBCGP - VSC Premium Reimbursement	VID:1113240126215	Voucher	850	850	1	1	1	850
1427886083949	621	6271.0	71.0	CBCGP - VSC Premium Reimbursement	VID:1113240126215	Voucher - Void	850	850	1	1	1	850
1427899181132	622	6270.0	-1.0	EOT Excess Mileage Fee Waiver	VID:1113240126315	Voucher	850	850	1	1	1	850
1427899352430	623	6271.0	1.0	EOT Excess Mileage Fee Waiver	VID:1113240126315	Voucher - Void	850	850	1	1	1	850
1427907638141	624	6256.0	-15.0	Dealer Dividend Cash	VID:1113240126415	Voucher	850	850	1	1	1	850
1428011478206	625	6255.0	-1.0	EOT Excess Wear Fee Waiver	VID:1113240126515	Voucher	850	850	1	1	1	850
1428011499255	626	6256.0	1.0	EOT Excess Wear Fee Waiver	VID:1113240126515	Voucher - Void	850	850	1	1	1	850
1428073976709	627	6255.0	-1.0	EOT Excess Mileage Fee Waiver	VID:1113240126715	Voucher	850	850	1	1	1	850
1428077806727	628	6254.0	-1.0	EOT Excess Mileage Fee Waiver	VID:1113240126815	Voucher	850	850	1	1	1	850
1428420105845	629	16252.0	-2.0	Dealer Dividend Cash	VID:1113240127215	Voucher	850	850	1	1	1	850
1428425342837	630	15752.0	-500.0	Retail Down Payment Assistance	VID:1113240130315	Voucher	850	850	1	1	1	850
1428432161654	631	14252.0	-1500.0	Retail Down Payment Assistance	VID:1113240132115	Voucher	850	850	1	1	1	850
1428432885259	632	13752.0	-500.0	Lease CCR	VID:1113240132215	Voucher	850	850	1	1	1	850
1428432924726	633	13333.0	-419.0	CPO Certification Fee Reimbursement	VID:1113240132315	Voucher	850	850	1	1	1	850
1428433009917	634	12998.0	-335.0	XS Wear Premium Reimbursement	VID:1113240132415	Voucher	850	850	1	1	1	850
1428433081161	635	12498.0	-500.0	GM Accessories Reimbursement	VID:1113240132515	Voucher	850	850	1	1	1	850
1428433677821	636	12497.0	-1.0	EOT Excess Mileage Fee Waiver	VID:1113240133815	Voucher	850	850	1	1	1	850
1428434107344	637	11997.0	-500.0	GMF DealerSource Vehicle Purchase Rebate	VID:1113240133915	Voucher	850	850	1	1	1	850
1428434173007	638	10997.0	-1000.0	GMF Dealership Training Discount	VID:1113240134015	Voucher	850	850	1	1	1	850
1428434202539	639	10995.0	-2.0	Dealer Dividend Cash	VID:1113240134215	Voucher	850	850	1	1	1	850
1428438376256	640	10985.0	-10.0	EOT Excess Mileage Fee Waiver	VID:1113240134415	Voucher	850	850	1	1	1	850
1428438581054	641	10983.0	-2.0	Dealer Dividend Cash	VID:1113240134515	Voucher	850	850	1	1	1	850
1428438916438	642	10982.0	-1.0	CBCGP - GAP Premium Reimbursement	VID:1113240134615	Voucher	850	850	1	1	1	850
1428439257620	643	10972.0	-10.0	CBCGP  - Tire & Wheel Premium Reimbursement	VID:1113240134815	Voucher	850	850	1	1	1	850
1428489987255	644	10472.0	-500.0	Retail Down Payment Assistance	VID:1113240134915	Voucher	850	850	1	1	1	850
1428490297768	645	10372.0	-100.0	CBCGP - VSC Premium Reimbursement	VID:1113240135315	Voucher	850	850	1	1	1	850
1428491029146	646	10252.0	-120.0	EOT Excess Mileage Fee Waiver	VID:1113240135715	Voucher	850	850	1	1	1	850
1428491127650	647	10752.0	500.0	Retail Down Payment Assistance	VID:1113240134915	Voucher - Void	850	850	1	1	1	850
1428491138166	648	10852.0	100.0	CBCGP - VSC Premium Reimbursement	VID:1113240135315	Voucher - Void	850	850	1	1	1	850
1428491174588	649	10972.0	120.0	EOT Excess Mileage Fee Waiver	VID:1113240135715	Voucher - Void	850	850	1	1	1	850
1428491487278	650	10808.0	-164.0	Dealer Dividend Cash	VID:1113240135815	Voucher	850	850	1	1	1	850
1428492075474	651	9808.0	-1000.0	GMF DealerSource Vehicle Purchase Rebate	VID:1113240136115	Voucher	850	850	1	1	1	850
1428503191060	652	9674.0	-134.0	Dealer Dividend Cash	VID:1113240136315	Voucher	850	850	1	1	1	850
1428509265139	653	9673.0	-1.0	EOT Excess Mileage Fee Waiver	VID:1113240136515	Voucher	850	850	1	1	1	850
1428509355006	654	9672.0	-1.0	CBCGP - GAP Premium Reimbursement	VID:1113240136715	Voucher	850	850	1	1	1	850
1428509373173	655	9673.0	1.0	CBCGP - GAP Premium Reimbursement	VID:1113240136715	Voucher - Void	850	850	1	1	1	850
1428509383598	656	9674.0	1.0	EOT Excess Mileage Fee Waiver	VID:1113240136515	Voucher - Void	850	850	1	1	1	850
1428509388093	657	10674.0	1000.0	GMF DealerSource Vehicle Purchase Rebate	VID:1113240136115	Voucher - Void	850	850	1	1	1	850
1428509401320	658	10684.0	10.0	CBCGP  - Tire & Wheel Premium Reimbursement	VID:1113240134815	Voucher - Void	850	850	1	1	1	850
1428509416078	659	11184.0	500.0	GMF DealerSource Vehicle Purchase Rebate	VID:1113240133915	Voucher - Void	850	850	1	1	1	850
1428509422349	660	11684.0	500.0	GM Accessories Reimbursement	VID:1113240132515	Voucher - Void	850	850	1	1	1	850
1428509428402	661	11685.0	1.0	EOT Excess Mileage Fee Waiver	VID:1113240133815	Voucher - Void	850	850	1	1	1	850
1428509437127	662	11695.0	10.0	EOT Excess Mileage Fee Waiver	VID:1113240134415	Voucher - Void	850	850	1	1	1	850
1428509446280	663	13195.0	1500.0	Retail Down Payment Assistance	VID:1113240132115	Voucher - Void	850	850	1	1	1	850
1428509469685	664	13695.0	500.0	Lease CCR	VID:1113240132215	Voucher - Void	850	850	1	1	1	850
1428509474721	665	14195.0	500.0	Retail Down Payment Assistance	VID:1113240130315	Voucher - Void	850	850	1	1	1	850
1428509791739	666	14194.0	-1.0	CBCGP - Maintenance Premium Reimbursement	VID:1113240136915	Voucher	850	850	1	1	1	850
1428509875215	667	14195.0	1.0	CBCGP - Maintenance Premium Reimbursement	VID:1113240136915	Voucher - Void	850	850	1	1	1	850
1428510022548	668	9865.0	-4330.0	CBCGP  - Tire & Wheel Premium Reimbursement	VID:1113240137015	Voucher	850	850	1	1	1	850
1428511749328	669	9440.0	-425.0	XS Wear Premium Reimbursement	VID:1113240137115	Voucher	850	850	1	1	1	850
1428515071937	670	9438.0	-2.0	Dealer Dividend Cash	VID:1113240139115	Voucher	850	850	1	1	1	850
1428517966992	671	9863.0	425.0	XS Wear Premium Reimbursement	VID:1113240137115	Voucher - Void	850	850	1	1	1	850
1428517973783	672	14193.0	4330.0	CBCGP  - Tire & Wheel Premium Reimbursement	VID:1113240137015	Voucher - Void	850	850	1	1	1	850
1428519245771	673	14191.0	-2.0	CBCGP  - Tire & Wheel Premium Reimbursement	VID:1113240139315	Voucher	850	850	1	1	1	850
1428520262747	674	13691.0	-500.0	Retail Down Payment Assistance	VID:1113240139515	Voucher	850	850	1	1	1	850
1428520310148	675	13191.0	-500.0	Lease CCR	VID:1113240139615	Voucher	850	850	1	1	1	850
1428520343663	676	13189.0	-2.0	Dealer Dividend Cash	VID:1113240139715	Voucher	850	850	1	1	1	850
1428520366575	677	12820.0	-369.0	CPO Certification Fee Reimbursement	VID:1113240139815	Voucher	850	850	1	1	1	850
1428520396079	678	12395.0	-425.0	XS Wear Premium Reimbursement	VID:1113240139915	Voucher	850	850	1	1	1	850
1428520461934	679	11895.0	-500.0	GM Accessories Reimbursement	VID:1113240140115	Voucher	850	850	1	1	1	850
1428520559624	680	11893.0	-2.0	Dealer Dividend Cash	VID:1113240140415	Voucher	850	850	1	1	1	850
1428520566911	681	11891.0	-2.0	Dealer Dividend Cash	VID:1113240140515	Voucher	850	850	1	1	1	850
1428520568306	682	11890.0	-1.0	CBCGP - GAP Premium Reimbursement	VID:1113240140215	Voucher	850	850	1	1	1	850
1428521336322	683	11888.0	-2.0	Dealer Dividend Cash	VID:1113240142115	Voucher	850	850	1	1	1	850
1428521391471	684	11889.0	1.0	CBCGP - GAP Premium Reimbursement	VID:1113240140215	Voucher - Void	850	850	1	1	1	850
1428521401510	685	12389.0	500.0	GM Accessories Reimbursement	VID:1113240140115	Voucher - Void	850	850	1	1	1	850
1428521410030	686	12814.0	425.0	XS Wear Premium Reimbursement	VID:1113240139915	Voucher - Void	850	850	1	1	1	850
1428521415001	687	13183.0	369.0	CPO Certification Fee Reimbursement	VID:1113240139815	Voucher - Void	850	850	1	1	1	850
1428521420884	688	13683.0	500.0	Lease CCR	VID:1113240139615	Voucher - Void	850	850	1	1	1	850
1428521426244	689	14183.0	500.0	Retail Down Payment Assistance	VID:1113240139515	Voucher - Void	850	850	1	1	1	850
1428521440763	690	14185.0	2.0	CBCGP  - Tire & Wheel Premium Reimbursement	VID:1113240139315	Voucher - Void	850	850	1	1	1	850
1428522584738	691	14183.0	-2.0	Dealer Dividend Cash	VID:1113240142315	Voucher	850	850	1	1	1	850
1428522737937	692	14181.0	-2.0	Dealer Dividend Cash	VID:1113240142415	Voucher	850	850	1	1	1	850
1428525070429	693	14179.0	-2.0	Dealer Dividend Cash	VID:1113240142515	Voucher	850	850	1	1	1	850
1428525951583	694	14180.0	1.0	EOT Excess Mileage Fee Waiver	VID:1113240126715	Voucher - Void	850	850	1	1	1	850
1428525967286	695	13680.0	-500.0	Retail Down Payment Assistance	VID:1113240142715	Voucher	850	850	1	1	1	850
1428526494384	696	13678.0	-2.0	Dealer Dividend Cash	VID:1113240142815	Voucher	850	850	1	1	1	850
1428526628751	697	13676.0	-2.0	Dealer Dividend Cash	VID:1113240142915	Voucher	850	850	1	1	1	850
1428527049690	698	13674.0	-2.0	Dealer Dividend Cash	VID:1113240143015	Voucher	850	850	1	1	1	850
1428527186905	699	13672.0	-2.0	Dealer Dividend Cash	VID:1113240143115	Voucher	850	850	1	1	1	850
1428527216801	700	13673.0	1.0	EOT Excess Mileage Fee Waiver	VID:1113240126815	Voucher - Void	850	850	1	1	1	850
1428527236030	701	13173.0	-500.0	Retail Down Payment Assistance	VID:1113240143215	Voucher	850	850	1	1	1	850
1428527856997	702	13171.0	-2.0	Dealer Dividend Cash	VID:1113240143315	Voucher	850	850	1	1	1	850
1428527918899	703	13169.0	-2.0	Dealer Dividend Cash	VID:1113240143415	Voucher	850	850	1	1	1	850
1428527976203	704	13167.0	-2.0	Dealer Dividend Cash	VID:1113240143515	Voucher	850	850	1	1	1	850
1428527993024	705	13165.0	-2.0	Dealer Dividend Cash	VID:1113240143615	Voucher	850	850	1	1	1	850
1428528128832	706	13164.0	-1.0	EOT Excess Mileage Fee Waiver	VID:1113240143715	Voucher	850	850	1	1	1	850
1428564655068	707	13664.0	500.0	Retail Down Payment Assistance	VID:1113240143215	Voucher - Void	850	850	1	1	1	850
1428566987897	708	13239.0	-425.0	XS Wear Premium Reimbursement	VID:1113240144115	Voucher	850	850	1	1	1	850
1428567203553	709	13664.0	425.0	XS Wear Premium Reimbursement	VID:1113240144115	Voucher - Void	850	850	1	1	1	850
1428567247007	710	13564.0	-100.0	CBCGP - GAP Premium Reimbursement	VID:1113240144215	Voucher	850	850	1	1	1	850
1428567453484	711	13664.0	100.0	CBCGP - GAP Premium Reimbursement	VID:1113240144215	Voucher - Void	850	850	1	1	1	850
1428567627400	712	9857.0	-3807.0	CBCGP - GAP Premium Reimbursement	VID:1113240144315	Voucher	850	850	1	1	1	850
1428567911378	713	13664.0	3807.0	CBCGP - GAP Premium Reimbursement	VID:1113240144315	Voucher - Void	850	850	1	1	1	850
1428567978619	714	13530.0	-134.0	Dealer Dividend Cash	VID:1113240144415	Voucher	850	850	1	1	1	850
1428575520479	715	13111.0	-419.0	CPO Certification Fee Reimbursement	VID:1113240144515	Voucher	850	850	1	1	1	850
1428576304919	716	12111.0	-1000.0	GMF Dealership Training Discount	VID:1113240144615	Voucher	850	850	1	1	1	850
1428591412294	717	12109.0	-2.0	Dealer Dividend Cash	VID:1113240144715	Voucher	850	850	1	1	1	850
1428591921723	718	12107.0	-2.0	Dealer Dividend Cash	VID:1113240144815	Voucher	850	850	1	1	1	850
1428592173750	719	12105.0	-2.0	Dealer Dividend Cash	VID:1113240144915	Voucher	850	850	1	1	1	850
1428592240425	720	12103.0	-2.0	Dealer Dividend Cash	VID:1113240145015	Voucher	850	850	1	1	1	850
1428592261163	721	12101.0	-2.0	Dealer Dividend Cash	VID:1113240145115	Voucher	850	850	1	1	1	850
1428607872540	722	12100.0	-1.0	EOT Excess Mileage Fee Waiver	VID:1113240145215	Voucher	850	850	1	1	1	850
1428662619624	723	11675.0	-425.0	XS Wear Premium Reimbursement	VID:1113240145415	Voucher	850	850	1	1	1	850
1428662730033	724	11665.0	-10.0	CBCGP  - Tire & Wheel Premium Reimbursement	VID:1113240145515	Voucher	850	850	1	1	1	850
1428662855267	725	11675.0	10.0	CBCGP  - Tire & Wheel Premium Reimbursement	VID:1113240145515	Voucher - Void	850	850	1	1	1	850
1428702417656	726	12100.0	425.0	XS Wear Premium Reimbursement	VID:1113240145415	Voucher - Void	850	850	1	1	1	850
1428702425719	727	12101.0	1.0	CBCGP - GAP Premium Reimbursement	VID:1113240134615	Voucher - Void	850	850	1	1	1	850
1428702576431	728	11601.0	-500.0	Retail Down Payment Assistance	VID:1113240145715	Voucher	850	850	1	1	1	850
1428702615109	729	11101.0	-500.0	Lease CCR	VID:1113240145815	Voucher	850	850	1	1	1	850
1428702651061	730	10732.0	-369.0	CPO Certification Fee Reimbursement	VID:1113240145915	Voucher	850	850	1	1	1	850
1428702675227	731	10307.0	-425.0	XS Wear Premium Reimbursement	VID:1113240146015	Voucher	850	850	1	1	1	850
1428702707383	732	10306.0	-1.0	EOT Excess Mileage Fee Waiver	VID:1113240146215	Voucher	850	850	1	1	1	850
1428702757862	733	10305.0	-1.0	EOT Excess Wear Fee Waiver	VID:1113240146315	Voucher	850	850	1	1	1	850
1428702813912	734	10304.0	-1.0	CBCGP - GAP Premium Reimbursement	VID:1113240146415	Voucher	850	850	1	1	1	850
1428702859788	735	10303.0	-1.0	CBCGP - VSC Premium Reimbursement	VID:1113240146515	Voucher	850	850	1	1	1	850
1428702898613	736	10302.0	-1.0	CBCGP - Tire & Wheel Premium Reimbursement	VID:1113240146715	Voucher	850	850	1	1	1	850
1428702921519	737	10301.0	-1.0	CBCGP - Maintenance Premium Reimbursement	VID:1113240146815	Voucher	850	850	1	1	1	850
1428702949741	738	9801.0	-500.0	GMF DealerSource Vehicle Purchase Rebate	VID:1113240146915	Voucher	850	850	1	1	1	850
1428702973322	739	8801.0	-1000.0	GMF Dealership Training Discount	VID:1113240147015	Voucher	850	850	1	1	1	850
1428702999370	740	8301.0	-500.0	GM Accessories Reimbursement	VID:1113240147115	Voucher	850	850	1	1	1	850
1428703015909	741	8299.0	-2.0	Dealer Dividend Cash	VID:1113240147215	Voucher	850	850	1	1	1	850
1429572893433	742	8799.0	500.0	GM Accessories Reimbursement	VID:1113240147115	Voucher - Void	850	850	1	1	1	850
1429572961922	743	8798.0	-1.0	CBCGP - Maintenance Premium Reimbursement	VID:1113240147515	Voucher	850	850	1	1	1	850
1429573009137	744	8799.0	1.0	CBCGP - Maintenance Premium Reimbursement	VID:1113240147515	Voucher - Void	850	850	1	1	1	850
1429573029041	745	8798.0	-1.0	CBCGP - Maintenance Premium Reimbursement	VID:1113240147715	Voucher	850	850	1	1	1	850
1429573052245	746	8799.0	1.0	CBCGP - Maintenance Premium Reimbursement	VID:1113240147715	Voucher - Void	850	850	1	1	1	850
1429573066954	747	8798.0	-1.0	CBCGP - Maintenance Premium Reimbursement	VID:1113240147815	Voucher	850	850	1	1	1	850
1429607221081	748	8379.0	-419.0	CPO Certification Fee Reimbursement	VID:1113240147915	Voucher	850	850	1	1	1	850
1429616696162	749	8798.0	419.0	CPO Certification Fee Reimbursement	VID:1113240147915	Voucher - Void	850	850	1	1	1	850
1429616840029	750	8638.0	-160.0	Dealer Dividend Cash	VID:1113240148015	Voucher	850	850	1	1	1	850
1429704769105	751	8213.0	-425.0	XS Wear Premium Reimbursement	VID:1113240148715	Voucher	850	850	1	1	1	850
1429713481243	752	8211.0	-2.0	Dealer Dividend Cash	VID:1113240148815	Voucher	850	850	1	1	1	850
1429713543426	753	8210.0	-1.0	EOT Excess Mileage Fee Waiver	VID:1113240148915	Voucher	850	850	1	1	1	850
1429713645284	754	8209.0	-1.0	EOT Excess Wear Fee Waiver	VID:1113240149015	Voucher	850	850	1	1	1	850
1429713670398	755	8208.0	-1.0	CBCGP - GAP Premium Reimbursement	VID:1113240149115	Voucher	850	850	1	1	1	850
1429713689338	756	8207.0	-1.0	CBCGP - VSC Premium Reimbursement	VID:1113240149215	Voucher	850	850	1	1	1	850
1429713758347	757	8205.0	-2.0	CBCGP - Tire & Wheel Premium Reimbursement	VID:1113240149315	Voucher	850	850	1	1	1	850
1429713779524	758	7705.0	-500.0	GM Accessories Reimbursement	VID:1113240149415	Voucher	850	850	1	1	1	850
1429714021942	759	7205.0	-500.0	Retail Down Payment Assistance	VID:1113240149915	Voucher	850	850	1	1	1	850
1429714052859	760	6705.0	-500.0	Lease CCR	VID:1113240150015	Voucher	850	850	1	1	1	850
1429714107252	761	6336.0	-369.0	CPO Certification Fee Reimbursement	VID:1113240150115	Voucher	850	850	1	1	1	850
1429714167443	762	6331.0	-5.0	CBCGP - Maintenance Premium Reimbursement	VID:1113240150215	Voucher	850	850	1	1	1	850
1429714248323	763	5331.0	-1000.0	GMF Dealership Training Discount	VID:1113240150315	Voucher	850	850	1	1	1	850
1429714419137	764	4831.0	-500.0	GMF DealerSource Vehicle Purchase Rebate	VID:1113240150415	Voucher	850	850	1	1	1	850
1429731568443	765	5331.0	500.0	GMF DealerSource Vehicle Purchase Rebate	VID:1113240150415	Voucher - Void	850	850	1	1	1	850
1429731576858	766	5336.0	5.0	CBCGP - Maintenance Premium Reimbursement	VID:1113240150215	Voucher - Void	850	850	1	1	1	850
1429731583686	767	5705.0	369.0	CPO Certification Fee Reimbursement	VID:1113240150115	Voucher - Void	850	850	1	1	1	850
1429731595637	768	6205.0	500.0	Lease CCR	VID:1113240150015	Voucher - Void	850	850	1	1	1	850
1429731611478	769	6705.0	500.0	Retail Down Payment Assistance	VID:1113240149915	Voucher - Void	850	850	1	1	1	850
1429731626846	770	7205.0	500.0	GM Accessories Reimbursement	VID:1113240149415	Voucher - Void	850	850	1	1	1	850
1429731653052	771	7630.0	425.0	XS Wear Premium Reimbursement	VID:1113240148715	Voucher - Void	850	850	1	1	1	850
1429731667062	772	7631.0	1.0	EOT Excess Mileage Fee Waiver	VID:1113240148915	Voucher - Void	850	850	1	1	1	850
1429731682777	773	7632.0	1.0	CBCGP - VSC Premium Reimbursement	VID:1113240149215	Voucher - Void	850	850	1	1	1	850
1429731695786	774	7633.0	1.0	CBCGP - GAP Premium Reimbursement	VID:1113240149115	Voucher - Void	850	850	1	1	1	850
1429731708501	775	7634.0	1.0	EOT Excess Wear Fee Waiver	VID:1113240149015	Voucher - Void	850	850	1	1	1	850
1429735763350	776	7134.0	-500.0	GMF DealerSource Vehicle Purchase Rebate	VID:1113240150515	Voucher	850	850	1	1	1	850
1429789006364	777	6134.0	-1000.0	GMF Dealership Training Discount	VID:1113240151015	Voucher	850	850	1	1	1	850
1429789116960	778	6089.0	-45.0	EOT Excess Mileage Fee Waiver	VID:1113240151115	Voucher	850	850	1	1	1	850
1429789161550	779	6134.0	45.0	EOT Excess Mileage Fee Waiver	VID:1113240151115	Voucher - Void	850	850	1	1	1	850
1429877899705	780	6034.0	-100.0	CBCGP - GAP Premium Reimbursement	VID:1113240151215	Voucher	850	850	1	1	1	850
1430132237958	781	5615.0	-419.0	CPO Certification Fee Reimbursement	VID:1113240151315	Voucher	850	850	1	1	1	850
1430132339109	782	5481.0	-134.0	Dealer Dividend Cash	VID:1113240151515	Voucher	850	850	1	1	1	850
1430153491234	783	5479.0	-2.0	Dealer Dividend Cash	VID:1113240151715	Voucher	850	850	1	1	1	850
1430153779706	784	3479.0	-2000.0	Retail Down Payment Assistance	VID:1113240151815	Voucher	850	850	1	1	1	850
1430221697758	785	3054.0	-425.0	XS Wear Premium Reimbursement	VID:1113240151915	Voucher	850	850	1	1	1	850
1430221779046	786	2554.0	-500.0	GM Accessories Reimbursement	VID:1113240152015	Voucher	850	850	1	1	1	850
1430221920266	787	2979.0	425.0	XS Wear Premium Reimbursement	VID:1113240151915	Voucher - Void	850	850	1	1	1	850
1430239492350	788	2479.0	-500.0	Retail Down Payment Assistance	VID:1113240152115	Voucher	850	850	1	1	1	850
1430239582989	789	2979.0	500.0	Retail Down Payment Assistance	VID:1113240152115	Voucher - Void	850	850	1	1	1	850
1430239621940	790	2554.0	-425.0	XS Wear Premium Reimbursement	VID:1113240152215	Voucher	850	850	1	1	1	850
1430239637930	791	2979.0	425.0	XS Wear Premium Reimbursement	VID:1113240152215	Voucher - Void	850	850	1	1	1	850
1430239663575	792	2978.0	-1.0	EOT Excess Mileage Fee Waiver	VID:1113240152315	Voucher	850	850	1	1	1	850
1430239687570	793	2979.0	1.0	EOT Excess Mileage Fee Waiver	VID:1113240152315	Voucher - Void	850	850	1	1	1	850
1430239710081	794	2970.0	-9.0	CBCGP - Tire & Wheel Premium Reimbursement	VID:1113240152415	Voucher	850	850	1	1	1	850
1430239727243	795	2979.0	9.0	CBCGP - Tire & Wheel Premium Reimbursement	VID:1113240152415	Voucher - Void	850	850	1	1	1	850
1430250561661	796	3479.0	500.0	GM Accessories Reimbursement	VID:1113240152015	Voucher - Void	850	850	1	1	1	850
1430250699150	797	3477.0	-2.0	Dealer Dividend Cash	VID:1113240152615	Voucher	850	850	1	1	1	850
1430316192721	798	3108.0	-369.0	CPO Certification Fee Reimbursement	VID:1113240152715	Voucher	850	850	1	1	1	850
1430316363655	799	3477.0	369.0	CPO Certification Fee Reimbursement	VID:1113240152715	Voucher - Void	850	850	1	1	1	850
1430316378252	800	3108.0	-369.0	CPO Certification Fee Reimbursement	VID:1113240152815	Voucher	850	850	1	1	1	850
1430316470080	801	3477.0	369.0	CPO Certification Fee Reimbursement	VID:1113240152815	Voucher - Void	850	850	1	1	1	850
1430316535816	802	3470.0	-7.0	CBCGP - Tire & Wheel Premium Reimbursement	VID:1113240153015	Voucher	850	850	1	1	1	850
1430329299438	803	3468.0	-2.0	Dealer Dividend Cash	VID:1113240153115	Voucher	850	850	1	1	1	850
1430333012324	804	3475.0	7.0	CBCGP - Tire & Wheel Premium Reimbursement	VID:1113240153015	Voucher - Void	850	850	1	1	1	850
1430333021903	805	5475.0	2000.0	Retail Down Payment Assistance	VID:1113240151815	Voucher - Void	850	850	1	1	1	850
1430333030389	806	5894.0	419.0	CPO Certification Fee Reimbursement	VID:1113240151315	Voucher - Void	850	850	1	1	1	850
1430333038076	807	5994.0	100.0	CBCGP - GAP Premium Reimbursement	VID:1113240151215	Voucher - Void	850	850	1	1	1	850
1430333047831	808	6494.0	500.0	GMF DealerSource Vehicle Purchase Rebate	VID:1113240150515	Voucher - Void	850	850	1	1	1	850
1430333059190	809	6496.0	2.0	CBCGP - Tire & Wheel Premium Reimbursement	VID:1113240149315	Voucher - Void	850	850	1	1	1	850
1430333069872	810	6996.0	500.0	Retail Down Payment Assistance	VID:1113240145715	Voucher - Void	850	850	1	1	1	850
1430333078597	811	7496.0	500.0	Lease CCR	VID:1113240145815	Voucher - Void	850	850	1	1	1	850
1430333088048	812	7865.0	369.0	CPO Certification Fee Reimbursement	VID:1113240145915	Voucher - Void	850	850	1	1	1	850
1430333096374	813	8290.0	425.0	XS Wear Premium Reimbursement	VID:1113240146015	Voucher - Void	850	850	1	1	1	850
1430333104615	814	8291.0	1.0	EOT Excess Mileage Fee Waiver	VID:1113240146215	Voucher - Void	850	850	1	1	1	850
1430333112570	815	8292.0	1.0	EOT Excess Wear Fee Waiver	VID:1113240146315	Voucher - Void	850	850	1	1	1	850
1430333121795	816	8293.0	1.0	CBCGP - GAP Premium Reimbursement	VID:1113240146415	Voucher - Void	850	850	1	1	1	850
1430333129482	817	8294.0	1.0	CBCGP - VSC Premium Reimbursement	VID:1113240146515	Voucher - Void	850	850	1	1	1	850
1430333137574	818	8295.0	1.0	CBCGP - Tire & Wheel Premium Reimbursement	VID:1113240146715	Voucher - Void	850	850	1	1	1	850
1430333147824	819	8296.0	1.0	CBCGP - Maintenance Premium Reimbursement	VID:1113240146815	Voucher - Void	850	850	1	1	1	850
1430333158768	820	8796.0	500.0	GMF DealerSource Vehicle Purchase Rebate	VID:1113240146915	Voucher - Void	850	850	1	1	1	850
1430333172090	821	8797.0	1.0	CBCGP - Maintenance Premium Reimbursement	VID:1113240147815	Voucher - Void	850	850	1	1	1	850
1430333184115	822	8798.0	1.0	EOT Excess Mileage Fee Waiver	VID:1113240145215	Voucher - Void	850	850	1	1	1	850
1430333193109	823	9217.0	419.0	CPO Certification Fee Reimbursement	VID:1113240144515	Voucher - Void	850	850	1	1	1	850
1430333203814	824	9218.0	1.0	EOT Excess Mileage Fee Waiver	VID:1113240143715	Voucher - Void	850	850	1	1	1	850
1430333213952	825	9718.0	500.0	Retail Down Payment Assistance	VID:1113240142715	Voucher - Void	850	850	1	1	1	850
1430333493818	826	9218.0	-500.0	Retail Down Payment Assistance	VID:1113240153315	Voucher	850	850	1	1	1	850
1430333536197	827	8718.0	-500.0	Lease CCR	VID:1113240153415	Voucher	850	850	1	1	1	850
1430333578008	828	8349.0	-369.0	CPO Certification Fee Reimbursement	VID:1113240153515	Voucher	850	850	1	1	1	850
1430333642052	829	7924.0	-425.0	XS Wear Premium Reimbursement	VID:1113240153615	Voucher	850	850	1	1	1	850
1430333701478	830	7923.0	-1.0	EOT Excess Mileage Fee Waiver	VID:1113240153715	Voucher	850	850	1	1	1	850
1430333738001	831	7922.0	-1.0	EOT Excess Wear Fee Waiver	VID:1113240153815	Voucher	850	850	1	1	1	850
1430333797477	832	7920.0	-2.0	CBCGP - GAP Premium Reimbursement	VID:1113240153915	Voucher	850	850	1	1	1	850
1430333826599	833	7919.0	-1.0	CBCGP - VSC Premium Reimbursement	VID:1113240154015	Voucher	850	850	1	1	1	850
1430333883861	834	7914.0	-5.0	CBCGP - Tire & Wheel Premium Reimbursement	VID:1113240154115	Voucher	850	850	1	1	1	850
1430333920436	835	7913.0	-1.0	CBCGP - Maintenance Premium Reimbursement	VID:1113240154215	Voucher	850	850	1	1	1	850
1430333965979	836	7413.0	-500.0	GMF DealerSource Vehicle Purchase Rebate	VID:1113240154315	Voucher	850	850	1	1	1	850
1430334028925	837	6413.0	-1000.0	GMF Dealership Training Discount	VID:1113240154415	Voucher	850	850	1	1	1	850
1430334094814	838	5913.0	-500.0	GM Accessories Reimbursement	VID:1113240154515	Voucher	850	850	1	1	1	850
1430334127106	839	5911.0	-2.0	Dealer Dividend Cash	VID:1113240154715	Voucher	850	850	1	1	1	850
1430334349811	840	5910.0	-1.0	EOT Excess Mileage Fee Waiver	VID:1113240154815	Voucher	850	850	1	1	1	850
1430335045732	841	6329.0	419.0	CPO Certification Fee Reimbursement	VID:1113240132315	Voucher - Void	850	850	1	1	1	850
1430726429808	842	5787.0	-123.0	EOT Excess Mileage Fee Waiver	VID:1113240155215	Voucher	850	850	1	1	1	850
1430731978596	843	5287.0	-500.0	CBCGP - GAP Premium Reimbursement	VID:1113240155315	Voucher	850	850	1	1	1	850
1430743144955	844	5787.0	500.0	CBCGP - GAP Premium Reimbursement	VID:1113240155315	Voucher - Void	850	850	1	1	1	850
1430743191107	845	5653.0	-134.0	Dealer Dividend Cash	VID:1113240155415	Voucher	850	850	1	1	1	850
1430762356364	846	5652.0	-1.0	CBCGP - Tire & Wheel Premium Reimbursement	VID:1113240155515	Voucher	850	850	1	1	1	850
1430842291060	847	5650.0	-2.0	Dealer Dividend Cash	VID:1113240155915	Voucher	850	850	1	1	1	850
1430842435226	848	5649.0	-1.0	CBCGP - VSC Premium Reimbursement	VID:1113240156115	Voucher	850	850	1	1	1	850
1430842477077	849	5648.0	-1.0	EOT Excess Wear Fee Waiver	VID:1113240156215	Voucher	850	850	1	1	1	850
1430842504336	850	5647.0	-1.0	CBCGP - VSC Premium Reimbursement	VID:1113240156315	Voucher	850	850	1	1	1	850
